CustomerID,Recency,Frequency,Monetary,R_Score,F_Score,M_Score,RFM_Score
12346.0,325,1,77183.6,1,1,4,6
12347.0,1,182,4310.0,4,4,4,12
12348.0,74,31,1797.24,2,2,4,8
12349.0,18,73,1757.55,3,3,4,10
12350.0,309,17,334.4,1,1,2,4
12352.0,35,85,2506.04,3,3,4,10
12353.0,203,4,89.0,1,1,1,3
12354.0,231,58,1079.4,1,3,3,7
12355.0,213,13,459.4,1,1,2,4
12356.0,22,59,2811.43,3,3,4,10
12357.0,32,131,6207.67,3,4,4,11
12358.0,1,19,1168.06,4,2,3,9
12359.0,57,248,6372.58,2,4,4,10
12360.0,51,129,2662.06,2,4,4,10
12361.0,286,10,189.9,1,1,1,3
12362.0,2,266,5226.23,4,4,4,12
12363.0,109,23,552.0,2,2,2,6
12364.0,7,85,1313.1,4,3,3,10
12365.0,290,22,641.38,1,2,2,5
12367.0,3,11,168.9,4,1,1,6
12370.0,50,167,3545.69,3,4,4,11
12371.0,44,63,1887.96,3,3,4,10
12372.0,71,52,1298.04,2,3,3,8
12373.0,310,14,364.6,1,1,2,4
12374.0,24,33,742.9300000000001,3,2,3,8
12375.0,10,17,457.5,4,1,2,7
12377.0,314,77,1628.12,1,3,3,7
12378.0,129,219,4008.62,2,4,4,10
12379.0,81,40,852.24,2,2,3,7
12380.0,21,104,2724.81,3,4,4,11
12381.0,4,87,1845.31,4,3,4,11
12383.0,184,99,1850.56,1,3,4,8
12384.0,28,27,585.27,3,2,2,7
12386.0,337,10,401.9,1,1,2,4
12388.0,15,100,2780.66,4,3,4,11
12390.0,79,32,549.84,2,2,2,6
12391.0,21,100,460.89,3,3,2,8
12393.0,71,64,1582.6000000000001,2,3,3,8
12394.0,63,27,1272.48,2,2,3,7
12395.0,18,156,3018.63,3,4,4,11
12397.0,35,126,2409.9,3,4,4,11
12398.0,45,85,1635.6599999999999,3,3,3,9
12399.0,118,59,1108.65,2,3,3,8
12401.0,302,5,84.3,1,1,1,3
12402.0,322,11,225.6,1,1,1,3
12403.0,49,5,427.7,3,1,2,6
12405.0,148,54,1710.39,1,3,4,8
12406.0,21,105,3415.3,3,4,4,11
12407.0,49,77,1708.1200000000001,3,3,4,10
12408.0,32,105,2888.55,3,4,4,11
12409.0,78,109,11072.67,2,4,4,10
12410.0,308,26,693.3299999999999,1,2,3,6
12412.0,74,61,1226.88,2,3,3,8
12413.0,66,38,758.1,2,2,3,7
12414.0,216,18,562.41,1,2,2,5
12415.0,23,716,124914.53,3,4,4,11
12417.0,2,192,3649.1,4,4,4,12
12418.0,112,34,668.58,2,2,2,6
12420.0,63,29,600.39,2,2,2,6
12421.0,15,45,807.04,4,3,3,10
12422.0,95,39,803.5600000000001,2,2,3,7
12423.0,0,125,1859.31,4,4,4,12
12424.0,162,30,1760.96,1,2,4,7
12425.0,77,36,777.2,2,2,3,7
12426.0,194,30,582.73,1,2,2,5
12427.0,21,31,825.8,3,2,3,8
12428.0,25,294,7956.46,3,4,4,11
12429.0,8,97,3750.4,4,3,4,11
12430.0,42,11,256.4,3,1,1,5
12431.0,35,236,6487.45,3,4,4,11
12432.0,42,108,5059.32,3,4,4,11
12433.0,0,420,13375.87,4,4,4,12
12434.0,84,50,806.14,2,3,3,8
12435.0,79,36,7829.89,2,2,4,8
12436.0,99,16,509.01,2,1,2,5
12437.0,1,200,4951.41,4,4,4,12
12438.0,13,98,2906.85,4,3,4,11
12441.0,366,11,173.55,1,1,1,3
12442.0,2,12,172.06,4,1,1,6
12444.0,20,177,5005.46,3,4,4,11
12445.0,21,4,133.4,3,1,1,5
12446.0,57,58,1002.3100000000001,2,3,3,8
12447.0,242,26,476.49,1,2,2,5
12448.0,43,22,449.45,3,2,2,7
12449.0,21,191,4067.29,3,4,4,11
12450.0,155,8,197.88,1,1,1,3
12451.0,10,354,9035.52,4,4,4,12
12452.0,16,22,430.57,4,2,2,8
12453.0,133,43,707.09,2,3,3,8
12454.0,55,15,3528.34,2,1,4,7
12455.0,72,90,2466.86,2,3,4,9
12456.0,43,125,3181.04,3,4,4,11
12457.0,65,63,2363.23,2,3,4,9
12458.0,70,38,947.4,2,2,3,7
12461.0,93,35,826.88,2,2,3,7
12462.0,18,62,1189.59,3,3,3,9
12463.0,52,83,1344.78,2,3,3,8
12464.0,9,29,1212.05,4,2,3,9
12465.0,16,47,742.1899999999999,4,3,3,10
12468.0,187,38,729.5400000000001,1,2,3,6
12471.0,1,460,19824.05,4,4,4,12
12472.0,31,339,6572.11,3,4,4,11
12473.0,28,168,3938.5499999999997,3,4,4,11
12474.0,16,424,7375.79,4,4,4,12
12475.0,53,36,723.38,2,2,3,7
12476.0,15,233,6816.42,4,4,4,12
12477.0,22,300,13219.74,3,4,4,11
12478.0,3,36,680.99,4,2,3,9
12479.0,10,31,527.2,4,2,2,8
12480.0,27,154,3281.63,3,4,4,11
12481.0,22,217,5596.32,3,4,4,11
12483.0,16,75,2484.98,4,3,4,11
12484.0,32,346,4541.72,3,4,4,11
12488.0,9,55,1298.66,4,3,3,10
12489.0,335,15,334.93,1,1,2,4
12490.0,4,245,5417.93,4,4,4,12
12491.0,38,26,460.40000000000003,3,2,2,7
12492.0,62,20,263.21000000000004,2,2,1,5
12493.0,165,22,433.74,1,2,2,5
12494.0,15,77,1246.1000000000001,4,3,3,10
12497.0,81,14,1043.1,2,1,3,6
12498.0,20,23,403.70000000000005,3,2,2,7
12500.0,22,61,4257.82,3,3,4,10
12501.0,336,149,2169.39,1,4,4,9
12502.0,95,147,3723.87,2,4,4,10
12504.0,17,9,482.04999999999995,4,1,2,7
12506.0,232,23,73.5,1,2,1,4
12507.0,133,22,1304.81,2,2,3,7
12508.0,25,69,398.27,3,3,2,8
12509.0,283,7,176.5,1,1,1,3
12510.0,142,33,982.5699999999999,1,2,3,6
12512.0,65,34,138.03,2,2,1,5
12513.0,112,35,612.29,2,2,2,6
12514.0,266,51,1017.68,1,3,3,7
12515.0,352,16,383.7,1,1,2,4
12516.0,77,26,1312.06,2,2,3,7
12517.0,27,284,2502.84,3,4,4,11
12518.0,0,124,2056.89,4,4,4,12
12519.0,63,18,340.84,2,2,2,6
12520.0,78,152,2634.26,2,4,4,10
12521.0,142,38,599.68,1,2,2,5
12522.0,38,12,192.72,3,1,1,5
12523.0,18,106,1789.77,3,4,4,11
12524.0,8,144,4485.72,4,4,4,12
12526.0,0,71,1316.66,4,3,3,10
12527.0,81,18,348.71000000000004,2,2,2,6
12528.0,8,92,1933.48,4,3,4,11
12530.0,59,66,1662.28,2,3,4,9
12531.0,14,17,125.22,4,1,1,6
12532.0,29,16,349.83000000000004,3,1,2,6
12534.0,130,63,1089.18,2,3,3,8
12535.0,91,34,716.35,2,2,3,7
12536.0,42,261,12601.830000000002,3,4,4,11
12538.0,28,21,363.95,3,2,2,7
12539.0,21,273,5568.35,3,4,4,11
12540.0,19,478,13400.24,3,4,4,11
12541.0,29,52,981.18,3,3,3,9
12544.0,35,19,372.7,3,2,2,7
12545.0,74,50,1000.39,2,3,3,8
12546.0,46,69,1161.5,3,3,3,9
12547.0,197,8,207.79999999999998,1,1,1,3
12548.0,165,5,95.19999999999999,1,1,1,3
12550.0,78,57,964.83,2,3,3,8
12551.0,357,10,168.0,1,1,1,3
12552.0,38,20,437.82,3,2,2,7
12553.0,7,191,3692.28,4,4,4,12
12556.0,49,121,603.71,3,4,2,9
12557.0,15,33,11990.960000000001,4,2,4,10
12558.0,7,11,269.96,4,1,1,6
12559.0,310,21,561.71,1,2,2,5
12560.0,4,105,2134.01,4,4,4,12
12561.0,302,16,238.85,1,1,1,3
12562.0,7,168,3781.7400000000002,4,4,4,12
12564.0,260,21,456.9,1,2,2,5
12565.0,288,9,145.92,1,1,1,3
12566.0,85,19,351.65,2,2,2,6
12567.0,22,446,9401.28,3,4,4,11
12569.0,1,188,4124.69,4,4,4,12
12571.0,39,34,519.61,3,2,2,7
12572.0,8,60,1020.42,4,3,3,10
12573.0,226,28,160.54000000000002,1,2,1,4
12574.0,315,11,218.45,1,1,1,3
12576.0,35,88,1315.83,3,3,3,9
12577.0,34,147,657.8,3,4,2,9
12578.0,20,114,2794.51,3,4,4,11
12579.0,77,29,440.42,2,2,2,6
12580.0,246,24,415.7,1,2,2,5
12581.0,39,15,197.71,3,1,1,5
12582.0,238,22,511.36,1,2,2,5
12583.0,2,247,7281.38,4,4,4,12
12584.0,3,96,2338.15,4,3,4,11
12585.0,233,87,2040.1,1,3,4,8
12586.0,16,11,196.94000000000003,4,1,1,6
12587.0,7,4,144.0,4,1,1,6
12588.0,38,10,214.89999999999998,3,1,1,5
12589.0,28,35,646.68,3,2,2,7
12590.0,210,68,9864.26,1,3,4,8
12591.0,316,26,452.84999999999997,1,2,2,5
12592.0,91,18,437.6,2,2,2,6
12593.0,108,21,418.09999999999997,2,2,2,6
12594.0,37,118,3338.2200000000003,3,4,4,11
12596.0,50,27,618.27,3,2,2,7
12597.0,18,206,3811.22,3,4,4,11
12598.0,9,132,3023.08,4,4,4,12
12599.0,28,62,1032.58,3,3,3,9
12600.0,28,64,2599.04,3,3,4,10
12601.0,189,28,577.0600000000001,1,2,2,5
12602.0,58,12,153.12,2,1,1,4
12603.0,21,3,739.1999999999999,3,1,3,7
12604.0,78,16,254.18,2,1,1,4
12607.0,59,101,1579.51,2,4,3,9
12609.0,77,60,1126.85,2,3,3,8
12610.0,22,106,2099.54,3,4,4,11
12611.0,51,65,1193.32,2,3,3,8
12612.0,73,19,704.0400000000001,2,2,3,7
12613.0,56,153,3344.38,2,4,4,10
12614.0,277,20,315.6,1,2,2,5
12615.0,1,105,2291.19,4,4,4,12
12616.0,94,32,713.3,2,2,3,7
12617.0,28,42,355.53,3,3,2,8
12618.0,21,11,177.31,3,1,1,5
12619.0,15,90,3641.24,4,3,4,11
12620.0,14,92,1339.41,4,3,3,10
12621.0,1,467,13689.67,4,4,4,12
12622.0,231,11,180.1,1,1,1,3
12623.0,275,18,305.1,1,2,1,4
12624.0,105,38,641.13,2,2,2,6
12625.0,211,86,2683.82,1,3,4,8
12626.0,22,294,6620.48,3,4,4,11
12627.0,10,230,4478.53,4,4,4,12
12628.0,3,41,786.46,4,2,3,9
12630.0,9,64,1270.88,4,3,3,10
12631.0,56,31,640.5,2,2,2,6
12633.0,58,101,2163.98,2,4,4,10
12635.0,89,101,1689.18,2,4,4,10
12637.0,66,390,6021.9,2,4,4,10
12638.0,32,39,671.69,3,2,2,7
12639.0,238,22,486.1,1,2,2,5
12640.0,23,53,1174.58,3,3,3,9
12641.0,114,10,185.9,2,1,1,4
12642.0,24,47,1013.26,3,3,3,9
12643.0,127,24,3344.64,2,2,4,8
12644.0,129,31,477.91,2,2,2,6
12645.0,33,73,1775.18,3,3,4,10
12646.0,4,45,1346.97,4,3,3,10
12647.0,21,122,3722.82,3,4,4,11
12648.0,154,21,318.05,1,2,2,5
12649.0,106,31,623.51,2,2,2,6
12650.0,2,20,314.44,4,2,2,8
12651.0,334,9,114.0,1,1,1,3
12652.0,330,48,919.98,1,3,3,7
12653.0,148,43,2209.85,1,3,4,8
12654.0,10,38,601.98,4,2,2,8
12656.0,16,126,4051.17,4,4,4,12
12657.0,10,47,1643.18,4,3,3,10
12658.0,18,36,686.05,3,2,3,8
12659.0,29,5,91.68,3,1,1,5
12660.0,10,13,245.1,4,1,1,6
12662.0,0,230,3849.78,4,4,4,12
12664.0,7,37,4881.88,4,2,4,10
12665.0,324,3,63.0,1,1,1,3
12667.0,57,33,620.13,2,2,2,6
12668.0,11,161,3807.15,4,4,4,12
12669.0,150,101,2744.0299999999997,1,4,4,9
12670.0,9,92,2996.05,4,3,4,11
12672.0,329,10,225.89999999999998,1,1,1,3
12673.0,4,42,610.52,4,3,2,9
12674.0,38,83,1970.6,3,3,4,10
12676.0,24,45,1331.39,3,3,3,9
12678.0,41,165,17628.46,3,4,4,11
12679.0,58,48,1113.02,2,3,3,8
12680.0,0,52,862.81,4,3,3,10
12681.0,14,638,13787.54,4,4,4,12
12682.0,3,525,12288.22,4,4,4,12
12683.0,3,344,8476.57,4,4,4,12
12684.0,7,105,2283.63,4,4,4,12
12685.0,27,157,2863.08,3,4,4,11
12686.0,371,7,89.14,1,1,1,3
12688.0,113,171,4873.8099999999995,2,4,4,10
12689.0,25,72,1247.61,3,3,3,9
12690.0,205,16,389.01,1,1,2,4
12691.0,27,32,1035.8,3,2,3,8
12693.0,126,39,855.91,2,2,3,7
12694.0,69,37,869.67,2,2,3,7
12695.0,6,27,582.1,4,2,2,8
12697.0,28,41,957.59,3,2,3,8
12700.0,7,268,4939.99,4,4,4,12
12701.0,79,53,797.71,2,3,3,8
12702.0,19,12,219.0,3,1,1,5
12703.0,70,21,283.55,2,2,1,5
12704.0,6,88,2340.84,4,3,4,11
12705.0,14,334,6868.29,4,4,4,12
12707.0,291,33,603.42,1,2,2,5
12708.0,29,157,2712.91,3,4,4,11
12709.0,14,208,9736.52,4,4,4,12
12710.0,96,77,1149.02,2,3,3,8
12712.0,28,133,4396.13,3,4,4,11
12713.0,0,38,848.55,4,2,3,9
12714.0,8,259,4708.86,4,4,4,12
12715.0,105,21,353.86,2,2,2,6
12716.0,3,69,1053.49,4,3,3,10
12717.0,150,55,1030.98,1,3,3,7
12718.0,70,19,238.25,2,2,1,5
12719.0,4,39,644.95,4,2,2,8
12720.0,2,354,5781.73,4,4,4,12
12721.0,31,161,2656.13,3,4,4,11
12722.0,84,53,997.63,2,3,3,8
12723.0,3,69,725.07,4,3,3,10
12724.0,4,53,1031.41,4,3,3,10
12725.0,370,24,427.8,1,2,2,5
12726.0,27,124,2609.1,3,4,4,11
12727.0,10,139,3980.7,4,4,4,12
12728.0,70,46,836.33,2,3,3,8
12729.0,113,26,453.01,2,2,2,6
12731.0,23,274,18895.91,3,4,4,11
12732.0,179,12,236.26000000000002,1,1,1,3
12733.0,233,22,383.95,1,2,2,5
12734.0,352,4,110.39999999999999,1,1,1,3
12735.0,314,43,779.5699999999999,1,3,3,7
12736.0,332,4,234.0,1,1,1,3
12738.0,371,11,155.35,1,1,1,3
12739.0,77,38,1013.04,2,2,3,7
12740.0,63,27,427.6,2,2,2,6
12743.0,133,134,546.43,2,4,2,8
12744.0,51,222,21279.29,2,4,4,10
12747.0,1,103,4196.01,4,4,4,12
12748.0,0,4596,33719.73,4,4,4,12
12749.0,3,199,4090.88,4,4,4,12
12750.0,128,15,275.88,2,1,1,4
12752.0,80,53,4366.78,2,3,4,9
12753.0,22,197,21429.39,3,4,4,11
12754.0,235,63,3010.74,1,3,4,8
12755.0,280,4,3811.95,1,1,4,6
12756.0,86,4,112.07999999999998,2,1,1,4
12757.0,15,371,7857.1,4,4,4,12
12758.0,116,97,2791.59,2,3,4,9
12759.0,51,95,1531.44,2,3,3,8
12762.0,7,69,1898.52,4,3,4,11
12763.0,137,18,494.08,2,2,2,6
12764.0,316,45,1693.88,1,3,4,8
12766.0,3,310,6989.63,4,4,4,12
12769.0,238,32,1143.6,1,2,3,6
12770.0,210,12,1351.45,1,1,3,5
12772.0,59,55,892.47,2,3,3,8
12775.0,16,66,1386.04,4,3,3,10
12778.0,19,50,822.23,3,3,3,9
12779.0,37,149,3981.36,3,4,4,11
12781.0,63,25,826.74,2,2,3,7
12782.0,4,103,2330.92,4,4,4,12
12783.0,1,84,2225.91,4,3,4,11
12784.0,8,59,574.42,4,3,2,9
12785.0,363,14,311.95,1,1,2,4
12787.0,9,20,463.66,4,2,2,8
12789.0,64,4,91.85,2,1,1,4
12790.0,191,21,324.92,1,2,2,5
12791.0,373,2,192.60000000000002,1,1,1,3
12792.0,256,25,400.53999999999996,1,2,2,5
12793.0,334,24,545.48,1,2,2,5
12794.0,52,45,860.41,2,3,3,8
12795.0,18,14,430.48,3,1,2,6
12797.0,365,13,254.03,1,1,1,3
12798.0,9,8,6977.04,4,1,4,9
12802.0,186,25,427.58,1,2,2,5
12808.0,36,28,483.65000000000003,3,2,2,7
12809.0,177,25,489.31,1,2,2,5
12811.0,260,31,514.85,1,2,2,5
12812.0,44,15,229.64000000000001,3,1,1,5
12814.0,101,2,125.92,2,1,1,4
12815.0,147,47,1063.46,1,3,3,7
12816.0,95,29,572.2,2,2,2,6
12817.0,280,4,166.04,1,1,1,3
12818.0,261,14,1542.08,1,1,3,5
12820.0,2,59,942.34,4,3,3,10
12821.0,213,6,92.72,1,1,1,3
12822.0,70,46,948.88,2,3,3,8
12823.0,74,5,1759.5,2,1,4,7
12824.0,59,25,397.12,2,2,2,6
12826.0,2,91,1474.72,4,3,3,10
12827.0,5,25,430.15000000000003,4,2,2,8
12828.0,2,56,1018.71,4,3,3,10
12829.0,336,11,293.0,1,1,1,3
12830.0,37,38,6814.64,3,2,4,9
12831.0,261,9,215.05,1,1,1,3
12832.0,31,27,383.03,3,2,2,7
12833.0,144,24,417.38,1,2,2,5
12834.0,282,18,312.38,1,2,2,5
12836.0,58,175,2612.86,2,4,4,10
12837.0,172,12,134.1,1,1,1,3
12838.0,33,123,683.13,3,4,3,10
12839.0,2,314,5591.42,4,4,4,12
12840.0,143,113,2726.77,1,4,4,9
12841.0,4,420,4022.35,4,4,4,12
12842.0,69,34,1118.99,2,2,3,7
12843.0,65,103,1702.26,2,4,4,10
12844.0,28,52,325.96000000000004,3,3,2,8
12845.0,266,27,354.09,1,2,2,5
12847.0,21,91,871.54,3,3,3,9
12849.0,30,51,1050.8899999999999,3,3,3,9
12851.0,96,50,135.18,2,3,1,6
12852.0,294,17,311.55,1,1,2,4
12853.0,134,78,1957.1000000000001,2,3,4,9
12854.0,78,110,1324.5,2,4,3,9
12855.0,372,3,38.1,1,1,1,3
12856.0,7,314,2179.93,4,4,4,12
12857.0,210,46,1106.4,1,3,3,7
12863.0,51,5,521.2,2,1,2,5
12864.0,137,3,147.12,2,1,1,4
12865.0,25,95,1568.23,3,3,3,9
12866.0,282,26,559.12,1,2,2,5
12867.0,25,538,4036.82,3,4,4,11
12868.0,185,107,1607.0600000000002,1,4,3,8
12871.0,83,11,380.64,2,1,2,5
12872.0,326,66,599.97,1,3,2,6
12873.0,281,4,374.0,1,1,2,4
12875.0,142,2,343.2300000000001,1,1,2,4
12876.0,57,85,2218.02,2,3,4,9
12877.0,3,154,1535.77,4,4,3,11
12878.0,235,47,854.99,1,3,3,7
12879.0,44,10,573.22,3,1,2,6
12881.0,275,7,298.0,1,1,1,3
12882.0,8,13,1463.04,4,1,3,8
12883.0,24,42,703.47,3,3,3,9
12884.0,87,7,309.05,2,1,2,5
12885.0,62,71,1175.22,2,3,3,8
12886.0,67,82,1378.4,2,3,3,8
12888.0,213,5,354.12,1,1,2,4
12890.0,23,82,380.46999999999997,3,3,2,8
12891.0,185,3,331.0,1,1,2,4
12893.0,30,34,188.14,3,2,1,6
12895.0,41,22,372.8,3,2,2,7
12897.0,204,4,216.5,1,1,1,3
12901.0,8,116,17654.54,4,4,4,12
12902.0,264,10,138.68,1,1,1,3
12904.0,17,72,509.58,4,3,2,9
12906.0,11,63,2919.81,4,3,4,11
12908.0,175,2,750.0,1,1,3,5
12909.0,39,91,2178.67,3,3,4,10
12910.0,22,75,3075.04,3,3,4,10
12912.0,2,24,1662.3,4,2,4,10
12913.0,4,50,2483.63,4,3,4,11
12915.0,148,22,363.65,1,2,2,5
12916.0,138,107,3006.15,2,4,4,10
12917.0,127,2,594.0,2,1,2,5
12919.0,7,50,1335.19,4,3,3,10
12920.0,16,28,164.23,4,2,1,7
12921.0,8,720,16587.09,4,4,4,12
12922.0,160,28,405.38,1,2,2,5
12923.0,63,29,176.97,2,2,1,5
12924.0,87,30,933.7,2,2,3,7
12925.0,4,45,694.05,4,3,3,10
12928.0,34,84,2062.7000000000003,3,3,4,10
12929.0,311,8,117.85,1,1,1,3
12930.0,77,25,415.8,2,2,2,6
12931.0,21,82,42055.96,3,3,4,10
12933.0,23,106,607.53,3,4,2,9
12935.0,1,129,2160.7,4,4,4,12
12936.0,16,62,1063.9,4,3,3,10
12937.0,14,120,1504.27,4,4,3,11
12938.0,25,9,114.14,3,1,1,5
12939.0,63,47,11581.8,2,3,4,9
12940.0,54,99,913.54,2,3,3,8
12942.0,130,75,683.9,2,3,3,8
12944.0,35,30,604.51,3,2,2,7
12945.0,287,23,462.95,1,2,2,5
12947.0,143,97,1603.99,1,3,3,7
12948.0,15,116,2064.95,4,4,4,12
12949.0,30,215,4167.22,3,4,4,11
12950.0,1,23,1843.0,4,2,4,10
12951.0,8,63,1064.07,4,3,3,10
12952.0,5,79,1387.79,4,3,3,10
12953.0,9,17,329.85,4,1,2,7
12955.0,0,180,4757.16,4,4,4,12
12956.0,305,19,108.07,1,2,1,4
12957.0,9,238,4017.54,4,4,4,12
12962.0,6,16,266.39,4,1,1,6
12963.0,7,95,1856.63,4,3,4,11
12965.0,88,109,771.91,2,4,3,9
12966.0,9,10,160.18,4,1,1,6
12967.0,357,19,1660.9,1,2,3,6
12968.0,111,5,135.95,2,1,1,4
12970.0,6,151,452.24,4,4,2,10
12971.0,3,305,11189.91,4,4,4,12
12974.0,197,8,144.8,1,1,1,3
12976.0,211,22,738.6,1,2,3,6
12977.0,155,9,39.239999999999995,1,1,1,3
12980.0,157,20,7374.900000000001,1,2,4,7
12981.0,29,20,372.21999999999997,3,2,2,7
12982.0,242,28,390.54,1,2,2,5
12984.0,18,4,97.5,3,1,1,5
12985.0,0,76,1239.38,4,3,3,10
12987.0,73,28,558.7,2,2,2,6
12988.0,291,92,535.32,1,3,2,6
12989.0,2,64,6924.110000000001,4,3,4,11
12990.0,30,13,409.5,3,1,2,6
12991.0,22,31,503.76,3,2,2,7
12993.0,22,27,414.76,3,2,2,7
12994.0,3,61,974.4200000000001,4,3,3,10
12995.0,84,3,211.32,2,1,1,4
12997.0,21,59,1226.89,3,3,3,9
12999.0,195,28,455.88,1,2,2,5
13000.0,106,31,534.85,2,2,2,6
13001.0,3,339,9818.82,4,4,4,12
13002.0,317,7,120.94999999999999,1,1,1,3
13003.0,105,6,149.05,2,1,1,4
13004.0,11,404,5655.91,4,4,4,12
13005.0,173,26,513.7,1,2,2,5
13006.0,55,4,81.57,2,1,1,4
13008.0,322,14,229.46999999999997,1,1,1,3
13011.0,371,3,50.550000000000004,1,1,1,3
13012.0,8,89,1661.8400000000001,4,3,4,11
13013.0,0,219,4810.9400000000005,4,4,4,12
13014.0,10,110,3466.2799999999997,4,4,4,12
13015.0,52,176,3346.28,2,4,4,10
13016.0,72,47,789.89,2,3,3,8
13017.0,6,1,204.0,4,1,1,6
13018.0,15,458,7277.7,4,4,4,12
13021.0,3,131,2616.38,4,4,4,12
13023.0,63,40,689.9,2,2,3,7
13026.0,0,40,975.36,4,2,3,9
13027.0,113,26,6912.0,2,2,4,8
13028.0,22,45,661.3199999999999,3,3,2,8
13029.0,30,10,1247.5,3,1,3,7
13030.0,10,99,799.48,4,3,3,10
13032.0,51,71,1010.18,2,3,3,8
13033.0,356,11,190.55,1,1,1,3
13034.0,54,37,642.77,2,2,2,6
13035.0,73,27,921.88,2,2,3,7
13037.0,137,48,881.07,2,3,3,8
13038.0,79,28,908.46,2,2,3,7
13040.0,8,43,676.99,4,3,3,10
13043.0,272,13,516.42,1,1,2,4
13044.0,290,33,560.47,1,2,2,5
13045.0,98,18,305.28000000000003,2,2,1,5
13046.0,30,35,629.31,3,2,2,7
13047.0,31,172,3237.54,3,4,4,11
13048.0,13,136,1835.91,4,4,4,12
13049.0,63,14,656.6800000000001,2,1,2,5
13050.0,14,403,5836.86,4,4,4,12
13052.0,211,18,348.15000000000003,1,2,2,5
13055.0,77,76,1214.41,2,3,3,8
13058.0,24,8,271.40000000000003,3,1,1,5
13059.0,249,8,183.4,1,1,1,3
13060.0,253,15,307.53,1,1,2,4
13061.0,71,10,248.61,2,1,1,4
13062.0,190,11,346.98,1,1,2,4
13064.0,12,69,1119.49,4,3,3,10
13065.0,372,14,205.86,1,1,1,3
13066.0,23,48,470.8,3,3,2,8
13067.0,81,15,115.46000000000001,2,1,1,4
13068.0,9,2,344.0,4,1,2,7
13069.0,0,425,4436.12,4,4,4,12
13070.0,191,9,228.8,1,1,1,3
13072.0,266,7,177.15,1,1,1,3
13075.0,129,22,919.61,2,2,3,7
13077.0,0,112,729.27,4,4,3,11
13078.0,2,358,12627.94,4,4,4,12
13079.0,3,6,220.10000000000002,4,1,1,6
13080.0,178,6,58.08,1,1,1,3
13081.0,11,1028,28337.38,4,4,4,12
13082.0,125,73,3613.63,2,3,4,9
13083.0,3,18,303.75,4,2,1,7
13085.0,157,22,416.08000000000004,1,2,2,5
13089.0,2,1818,58825.83,4,4,4,12
13090.0,8,155,8910.82,4,4,4,12
13091.0,27,21,345.82,3,2,2,7
13092.0,70,25,477.83,2,2,2,6
13093.0,275,159,7832.47,1,4,4,9
13094.0,20,24,1927.3200000000002,3,2,4,9
13095.0,70,6,74.39999999999999,2,1,1,4
13097.0,32,423,6010.42,3,4,4,11
13098.0,0,572,28882.44,4,4,4,12
13099.0,98,1,207.35999999999999,2,1,1,4
13101.0,233,8,101.19,1,1,1,3
13102.0,0,304,6424.09,4,4,4,12
13103.0,39,8,243.94,3,1,1,5
13104.0,2,20,1098.48,4,2,3,9
13106.0,132,1,76.5,2,1,1,4
13107.0,43,58,1531.6200000000001,3,3,3,9
13108.0,372,10,350.06,1,1,2,4
13109.0,59,47,786.54,2,3,3,8
13110.0,30,145,1488.67,3,4,3,10
13113.0,0,201,12245.960000000001,4,4,4,12
13115.0,11,120,2294.78,4,4,4,12
13116.0,137,30,501.14,2,2,2,6
13117.0,21,76,984.91,3,3,3,9
13118.0,19,79,1197.81,3,3,3,9
13120.0,238,1,30.599999999999998,1,1,1,3
13121.0,268,50,283.73,1,3,1,5
13122.0,93,55,922.39,2,3,3,8
13124.0,89,235,3866.33,2,4,4,10
13126.0,4,140,2099.64,4,4,4,12
13127.0,77,15,259.17,2,1,1,4
13130.0,93,2,64.0,2,1,1,4
13131.0,22,44,1073.3,3,3,3,9
13132.0,261,3,77.3,1,1,1,3
13133.0,273,7,109.8,1,1,1,3
13134.0,85,98,1793.58,2,3,4,9
13135.0,196,1,3096.0,1,1,4,6
13136.0,55,127,2607.61,2,4,4,10
13137.0,10,704,3650.41,4,4,4,12
13138.0,21,63,962.39,3,3,3,9
13139.0,15,170,5064.94,4,4,4,12
13140.0,107,46,423.72,2,3,2,7
13141.0,84,135,2388.75,2,4,4,10
13142.0,18,23,307.09,3,2,1,6
13144.0,332,3,110.95,1,1,1,3
13145.0,39,6,618.52,3,1,2,6
13146.0,25,17,228.91,3,1,1,5
13147.0,9,4,712.8000000000001,4,1,3,8
13148.0,28,319,3707.12,3,4,4,11
13149.0,13,86,1676.06,4,3,4,11
13151.0,295,74,1257.8700000000001,1,3,3,7
13153.0,5,15,486.22,4,1,2,7
13155.0,32,85,971.76,3,3,3,9
13157.0,48,87,1741.22,3,3,4,10
13158.0,94,79,1201.06,2,3,3,8
13159.0,8,121,1437.85,4,4,3,11
13160.0,21,4,91.8,3,1,1,5
13161.0,312,8,112.75,1,1,1,3
13162.0,121,79,1688.29,2,3,4,9
13165.0,45,42,1021.48,3,3,3,9
13166.0,282,41,417.2,1,2,2,5
13167.0,18,65,791.33,3,3,3,9
13168.0,35,131,1319.19,3,4,3,10
13169.0,63,13,712.88,2,1,3,6
13170.0,26,32,116.00999999999999,3,2,1,6
13171.0,21,46,468.41,3,3,2,8
13173.0,3,43,353.65,4,3,2,9
13174.0,15,314,2817.03,4,4,4,12
13176.0,45,72,492.84,3,3,2,8
13177.0,64,17,282.45,2,1,1,4
13178.0,25,265,5725.47,3,4,4,11
13182.0,44,11,121.18,3,1,1,5
13183.0,7,94,3957.78,4,3,4,11
13184.0,14,181,1701.29,4,4,4,12
13185.0,267,1,71.4,1,1,1,3
13186.0,39,79,1575.89,3,3,3,9
13187.0,336,37,236.02,1,2,1,4
13188.0,10,2,114.60000000000001,4,1,1,6
13189.0,18,29,260.68,3,2,1,6
13192.0,94,63,911.94,2,3,3,8
13193.0,60,29,117.88,2,2,1,5
13194.0,135,3,60.7,2,1,1,4
13196.0,10,110,1797.78,4,4,4,12
13198.0,9,226,3401.2400000000002,4,4,4,12
13199.0,3,119,9817.12,4,4,4,12
13200.0,18,46,870.09,3,3,3,9
13203.0,9,57,869.46,4,3,3,10
13207.0,14,8,250.26000000000002,4,1,1,6
13208.0,58,149,1223.9,2,4,3,9
13209.0,29,321,5891.61,3,4,4,11
13210.0,93,22,353.48,2,2,2,6
13211.0,9,56,1197.42,4,3,3,10
13212.0,19,142,788.08,3,4,3,10
13213.0,56,90,1520.58,2,3,3,8
13216.0,267,5,333.74,1,1,2,4
13217.0,121,4,533.98,2,1,2,5
13218.0,126,5,62.63999999999999,2,1,1,4
13220.0,77,21,819.2900000000001,2,2,3,7
13221.0,239,66,847.41,1,3,3,7
13223.0,199,5,163.20000000000002,1,1,1,3
13224.0,59,108,2155.95,2,4,4,10
13225.0,2,32,6463.84,4,2,4,10
13226.0,272,16,108.21000000000001,1,1,1,3
13227.0,201,9,257.7,1,1,1,3
13228.0,80,2,358.0,2,1,2,5
13229.0,225,10,160.95,1,1,1,3
13230.0,3,611,2806.97,4,4,4,12
13232.0,12,207,1357.6,4,4,3,11
13233.0,73,43,605.12,2,3,2,7
13235.0,211,58,1031.07,1,3,3,7
13236.0,24,36,744.85,3,2,3,8
13238.0,16,31,700.73,4,2,3,9
13239.0,261,22,329.56,1,2,2,5
13240.0,95,67,663.65,2,3,2,7
13242.0,111,13,270.40000000000003,2,1,1,4
13243.0,202,58,600.07,1,3,2,6
13244.0,92,27,121.74000000000001,2,2,1,5
13245.0,50,16,430.5,3,1,2,6
13246.0,17,141,1987.3,4,4,4,12
13247.0,17,25,501.12,4,2,2,8
13248.0,124,26,465.68,2,2,2,6
13249.0,91,23,711.41,2,2,3,7
13253.0,156,36,1030.4,1,2,3,6
13255.0,8,13,399.51,4,1,2,7
13256.0,13,1,0.0,4,1,1,6
13258.0,11,38,698.58,4,2,3,9
13259.0,61,87,292.32,2,3,1,6
13260.0,60,8,557.62,2,1,2,5
13261.0,268,9,944.1,1,1,3,5
13262.0,262,11,200.29,1,1,1,3
13263.0,0,1677,7454.07,4,4,4,12
13265.0,52,91,2107.66,2,3,4,9
13266.0,10,187,3834.2599999999998,4,4,4,12
13267.0,2,211,4521.49,4,4,4,12
13268.0,17,440,3214.69,4,4,4,12
13269.0,0,316,5346.2300000000005,4,4,4,12
13270.0,365,1,590.0,1,1,2,4
13271.0,36,96,217.38,3,3,1,7
13272.0,30,15,276.56,3,1,1,5
13273.0,112,16,138.98,2,1,1,4
13276.0,63,30,590.9300000000001,2,2,2,6
13277.0,15,8,258.4,4,1,1,6
13278.0,40,46,542.73,3,3,2,8
13279.0,77,9,137.75,2,1,1,4
13280.0,121,85,814.86,2,3,3,8
13282.0,17,37,1132.14,4,2,3,9
13283.0,59,7,93.66,2,1,1,4
13284.0,330,13,201.19,1,1,1,3
13285.0,22,187,2709.12,3,4,4,11
13291.0,155,42,361.11,1,3,2,6
13292.0,38,31,578.9399999999999,3,2,2,7
13294.0,189,54,873.74,1,3,3,7
13295.0,359,10,201.20000000000002,1,1,1,3
13296.0,136,5,87.4,2,1,1,4
13297.0,7,59,2089.85,4,3,4,11
13298.0,0,2,360.0,4,1,2,7
13299.0,267,5,142.5,1,1,1,3
13300.0,168,20,371.89,1,2,2,5
13301.0,103,81,618.09,2,3,2,7
13302.0,154,1,63.75,1,1,1,3
13304.0,350,21,300.42,1,2,1,4
13305.0,3,81,2000.86,4,3,4,11
13307.0,119,1,15.0,2,1,1,4
13308.0,22,54,1385.51,3,3,3,9
13309.0,6,107,1456.79,4,4,3,11
13310.0,27,72,1132.03,3,3,3,9
13311.0,3,26,598.57,4,2,2,8
13313.0,21,78,1555.32,3,3,3,9
13314.0,1,62,775.94,4,3,3,10
13316.0,36,87,5977.7300000000005,3,3,4,10
13317.0,65,124,2273.68,2,4,4,10
13318.0,0,20,640.76,4,2,2,8
13319.0,4,476,10845.550000000001,4,4,4,12
13320.0,77,106,1548.7,2,4,3,9
13321.0,71,11,567.36,2,1,2,5
13322.0,16,25,199.48000000000002,4,2,1,7
13323.0,2,21,787.85,4,2,3,9
13324.0,35,75,7121.95,3,3,4,10
13325.0,81,12,675.3,2,1,3,6
13327.0,38,108,3627.77,3,4,4,11
13328.0,315,17,1308.48,1,1,3,5
13329.0,31,17,789.0,3,1,3,7
13330.0,92,53,1140.93,2,3,3,8
13332.0,13,21,350.9,4,2,2,8
13334.0,81,268,3536.82,2,4,4,10
13336.0,76,51,795.12,2,3,3,8
13338.0,157,19,487.02,1,2,2,5
13339.0,200,54,860.12,1,3,3,7
13340.0,44,134,10736.48,3,4,4,11
13341.0,260,42,775.85,1,3,3,7
13343.0,177,19,353.43,1,2,2,5
13344.0,67,119,2543.72,2,4,4,10
13345.0,287,20,389.5,1,2,2,5
13347.0,69,8,341.36,2,1,2,5
13348.0,63,14,233.76,2,1,1,4
13349.0,10,16,247.32,4,1,1,6
13350.0,15,40,979.12,4,2,3,9
13351.0,65,16,373.94,2,1,2,5
13352.0,59,24,397.97999999999996,2,2,2,6
13354.0,70,51,743.53,2,3,3,8
13355.0,121,32,674.7,2,2,3,7
13356.0,79,42,768.24,2,3,3,8
13357.0,256,90,609.95,1,3,2,6
13358.0,268,29,439.03,1,2,2,5
13359.0,63,23,439.56,2,2,2,6
13362.0,8,166,3090.7400000000002,4,4,4,12
13363.0,17,60,992.5,4,3,3,10
13364.0,70,10,134.95999999999998,2,1,1,4
13365.0,33,128,2225.37,3,4,4,11
13366.0,49,1,56.160000000000004,3,1,1,5
13368.0,256,29,623.4,1,2,2,5
13369.0,365,14,308.28000000000003,1,1,2,4
13370.0,371,39,754.87,1,2,3,6
13372.0,89,23,378.64,2,2,2,6
13373.0,60,158,3312.25,2,4,4,10
13375.0,88,37,778.65,2,2,3,7
13376.0,98,53,1019.76,2,3,3,8
13379.0,25,97,572.56,3,3,2,8
13381.0,31,172,3639.31,3,4,4,11
13382.0,280,15,222.99,1,1,1,3
13384.0,30,152,4151.93,3,4,4,11
13385.0,329,35,534.57,1,2,2,5
13388.0,130,35,677.1,2,2,3,7
13389.0,10,51,797.96,4,3,3,10
13390.0,74,13,544.08,2,1,2,5
13391.0,203,1,59.8,1,1,1,3
13394.0,1,155,2520.02,4,4,4,12
13395.0,184,21,307.72,1,2,2,5
13396.0,28,43,1360.99,3,3,3,9
13397.0,72,38,1544.13,2,2,3,7
13398.0,191,26,457.34,1,2,2,5
13402.0,126,39,621.23,2,2,2,6
13403.0,17,3,75.0,4,1,1,6
13404.0,0,11,252.49,4,1,1,6
13405.0,73,27,572.451,2,2,2,6
13408.0,1,478,28117.04,4,4,4,12
13410.0,23,28,1003.06,3,2,3,8
13411.0,106,18,213.55,2,2,1,5
13414.0,133,24,1390.5,2,2,3,7
13416.0,43,19,712.5,3,2,3,8
13417.0,4,28,640.83,4,2,2,8
13418.0,11,304,6127.43,4,4,4,12
13419.0,63,16,221.06,2,1,1,4
13420.0,149,8,159.85,1,1,1,3
13421.0,39,104,1851.08,3,4,4,11
13422.0,63,127,2626.3,2,4,4,10
13425.0,107,78,1624.21,2,3,3,8
13426.0,0,157,3641.32,4,4,4,12
13427.0,18,29,582.6,3,2,2,7
13428.0,9,74,218.47,4,3,1,8
13429.0,10,67,1006.8,4,3,3,10
13430.0,18,49,679.45,3,3,3,9
13431.0,66,46,1269.1,2,3,3,8
13434.0,73,10,534.24,2,1,2,5
13435.0,4,101,3809.8900000000003,4,4,4,12
13436.0,1,12,196.89,4,1,1,6
13437.0,13,167,3408.06,4,4,4,12
13439.0,254,54,283.71,1,3,1,5
13441.0,91,13,296.64,2,1,1,4
13447.0,22,59,1129.14,3,3,3,9
13448.0,16,195,3539.37,4,4,4,12
13449.0,23,19,291.88,3,2,1,6
13450.0,26,71,2043.7199999999998,3,3,4,10
13451.0,25,443,2976.15,3,4,4,11
13452.0,258,2,590.0,1,1,2,4
13453.0,165,17,356.97999999999996,1,1,2,4
13455.0,24,46,1058.34,3,3,3,9
13456.0,17,63,1766.72,4,3,4,11
13458.0,6,382,9646.57,4,4,4,12
13460.0,28,17,183.44,3,1,1,5
13461.0,38,27,1445.0,3,2,3,8
13462.0,252,9,151.5,1,1,1,3
13464.0,57,41,674.68,2,2,3,7
13466.0,183,17,307.9,1,1,2,4
13467.0,10,99,1083.71,4,3,3,10
13468.0,1,302,5704.97,4,4,4,12
13470.0,98,10,165.0,2,1,1,4
13471.0,0,260,2531.58,4,4,4,12
13473.0,60,21,422.64,2,2,2,6
13474.0,235,64,229.59,1,3,1,5
13475.0,190,86,1431.78,1,3,3,7
13476.0,178,58,1238.47,1,3,3,7
13477.0,37,79,1454.58,3,3,3,9
13479.0,200,15,300.95,1,1,1,3
13481.0,45,109,1804.56,3,4,4,11
13482.0,231,11,184.64,1,1,1,3
13483.0,65,10,140.34,2,1,1,4
13484.0,240,8,313.8,1,1,2,4
13485.0,232,23,454.24,1,2,2,5
13486.0,77,69,1122.41,2,3,3,8
13487.0,57,34,575.4,2,2,2,6
13488.0,16,422,8968.31,4,4,4,12
13489.0,104,14,449.52,2,1,2,5
13491.0,51,86,1215.82,2,3,3,8
13492.0,135,50,1269.84,2,3,3,8
13493.0,274,8,618.63,1,1,2,4
13494.0,311,18,316.26000000000005,1,2,2,5
13495.0,7,48,2044.8700000000001,4,3,4,11
13496.0,10,35,653.33,4,2,2,8
13497.0,282,19,348.05,1,2,2,5
13499.0,17,42,1159.11,4,3,3,10
13500.0,22,65,1166.77,3,3,3,9
13501.0,287,52,1340.32,1,3,3,7
13502.0,16,18,292.0,4,2,1,7
13503.0,70,17,216.85,2,1,1,4
13504.0,63,22,295.93,2,2,1,5
13505.0,72,215,4393.63,2,4,4,10
13506.0,315,26,458.52,1,2,2,5
13507.0,2,162,2479.16,4,4,4,12
13508.0,243,12,110.97,1,1,1,3
13509.0,8,44,979.72,4,3,3,10
13510.0,0,115,1791.56,4,4,4,12
13512.0,260,15,251.21,1,1,1,3
13513.0,126,10,205.1,2,1,1,4
13514.0,73,4,152.20000000000002,2,1,1,4
13515.0,72,59,891.12,2,3,3,8
13516.0,20,44,1389.41,3,3,3,9
13517.0,59,141,2128.42,2,4,4,10
13518.0,85,38,659.4399999999999,2,2,2,6
13519.0,77,8,122.75,2,1,1,4
13520.0,58,93,3624.35,2,3,4,9
13521.0,0,436,1093.65,4,4,3,11
13522.0,29,5,125.80000000000001,3,1,1,5
13523.0,32,172,3964.88,3,4,4,11
13524.0,40,27,680.1800000000001,3,2,3,8
13525.0,14,6,628.78,4,1,2,7
13527.0,33,223,2287.51,3,4,4,11
13529.0,78,15,307.76,2,1,2,5
13531.0,204,22,483.8,1,2,2,5
13532.0,33,66,210.31,3,3,1,7
13533.0,182,76,270.79,1,3,1,5
13534.0,1,296,5870.08,4,4,4,12
13536.0,0,179,3448.29,4,4,4,12
13538.0,42,25,1280.85,3,2,3,8
13539.0,85,37,631.34,2,2,2,6
13544.0,39,87,291.41,3,3,1,7
13546.0,11,98,626.99,4,3,2,9
13548.0,95,124,682.41,2,4,3,9
13549.0,25,51,918.2,3,3,3,9
13551.0,318,4,91.80000000000001,1,1,1,3
13552.0,65,109,3740.07,2,4,4,10
13555.0,73,136,4149.28,2,4,4,10
13557.0,27,34,584.06,3,2,2,7
13558.0,5,175,605.06,4,4,2,10
13560.0,6,33,174.37,4,2,1,7
13561.0,215,14,141.85999999999999,1,1,1,3
13562.0,81,82,1799.33,2,3,4,9
13563.0,83,49,777.53,2,3,3,8
13564.0,143,83,1749.02,1,3,4,8
13565.0,18,38,240.22,3,2,1,6
13566.0,40,176,874.71,3,4,3,10
13568.0,172,44,192.85,1,3,1,5
13569.0,16,85,373.75,4,3,2,9
13570.0,242,27,239.49,1,2,1,4
13571.0,12,341,2092.32,4,4,4,12
13572.0,205,33,1384.25,1,2,3,6
13573.0,49,26,294.4,3,2,1,6
13575.0,22,46,732.0699999999999,3,3,3,9
13576.0,9,126,6717.34,4,4,4,12
13577.0,24,83,1687.6000000000001,3,3,4,10
13579.0,14,23,467.04,4,2,2,8
13581.0,308,10,118.0,1,1,1,3
13583.0,155,53,781.03,1,3,3,7
13584.0,306,24,142.4,1,2,1,4
13587.0,63,8,712.4,2,1,3,6
13588.0,15,174,2478.95,4,4,4,12
13589.0,14,21,379.65,4,2,2,8
13590.0,10,87,1981.92,4,3,4,11
13591.0,64,58,1117.13,2,3,3,8
13592.0,35,16,247.95999999999998,3,1,1,5
13593.0,107,128,2037.0800000000002,2,4,4,10
13594.0,52,26,396.97,2,2,2,6
13596.0,5,166,697.04,4,4,3,11
13598.0,46,40,180.17000000000002,3,2,1,6
13599.0,0,247,5153.67,4,4,4,12
13600.0,311,19,219.52,1,2,1,4
13601.0,44,99,693.32,3,3,3,9
13602.0,64,23,428.89,2,2,2,6
13603.0,25,27,164.34,3,2,1,6
13606.0,28,43,280.53999999999996,3,3,1,7
13607.0,39,98,678.01,3,3,3,9
13610.0,11,226,1131.88,4,4,3,11
13611.0,88,74,1171.8,2,3,3,8
13614.0,23,201,1610.46,3,4,3,10
13615.0,318,23,417.69,1,2,2,5
13617.0,39,44,544.18,3,3,2,8
13618.0,173,13,177.34,1,1,1,3
13621.0,116,19,213.85,2,2,1,5
13623.0,30,81,747.78,3,3,3,9
13626.0,252,19,257.23,1,2,1,4
13627.0,58,92,1638.47,2,3,3,8
13629.0,22,59,7792.36,3,3,4,10
13630.0,4,71,2031.78,4,3,4,11
13631.0,99,11,3070.42,2,1,4,7
13632.0,24,146,2121.27,3,4,4,11
13634.0,32,188,1575.16,3,4,3,10
13635.0,67,62,1071.03,2,3,3,8
13636.0,36,63,949.12,3,3,3,9
13637.0,51,101,810.5,2,4,3,9
13638.0,15,8,122.64,4,1,1,6
13639.0,73,40,1033.34,2,2,3,7
13642.0,215,66,354.8,1,3,2,6
13643.0,30,28,519.44,3,2,2,7
13644.0,15,146,2624.26,4,4,4,12
13645.0,119,5,252.1,2,1,1,4
13647.0,9,79,1678.1200000000001,4,3,4,11
13649.0,256,23,346.6,1,2,2,5
13650.0,16,96,1836.34,4,3,4,11
13651.0,34,6,94.2,3,1,1,5
13652.0,45,63,1095.08,3,3,3,9
13654.0,42,166,2707.33,3,4,4,11
13655.0,113,56,932.97,2,3,3,8
13656.0,164,49,379.65,1,3,2,6
13657.0,10,16,382.14,4,1,2,7
13658.0,9,108,2639.17,4,4,4,12
13659.0,205,104,1573.2,1,4,3,8
13662.0,85,53,897.76,2,3,3,8
13663.0,178,13,189.47,1,1,1,3
13666.0,59,12,84.65,2,1,1,4
13667.0,148,87,305.02,1,3,1,5
13668.0,2,470,6363.59,4,4,4,12
13669.0,50,9,218.55,3,1,1,5
13670.0,74,25,349.7,2,2,2,6
13672.0,300,6,186.39000000000001,1,1,1,3
13673.0,18,65,396.92,3,3,2,8
13675.0,150,25,486.82000000000005,1,2,2,5
13678.0,151,16,232.6,1,1,1,3
13680.0,0,195,3722.42,4,4,4,12
13681.0,17,57,827.83,4,3,3,10
13682.0,186,3,59.5,1,1,1,3
13684.0,285,30,67.23,1,2,1,4
13685.0,2,39,3119.44,4,2,4,10
13686.0,182,8,72.0,1,1,1,3
13689.0,62,6,910.0,2,1,3,6
13690.0,58,9,172.25,2,1,1,4
13692.0,24,53,1488.32,3,3,3,9
13694.0,3,568,65039.62,4,4,4,12
13695.0,30,90,2504.13,3,3,4,10
13697.0,38,12,151.29999999999998,3,1,1,5
13699.0,154,14,308.58000000000004,1,1,2,4
13700.0,25,197,2265.12,3,4,4,11
13703.0,317,1,99.5,1,1,1,3
13704.0,4,134,2308.06,4,4,4,12
13705.0,7,28,711.86,4,2,3,9
13706.0,302,20,330.79,1,2,2,5
13707.0,266,48,806.41,1,3,3,7
13708.0,270,51,296.88,1,3,1,5
13709.0,3,336,6328.05,4,4,4,12
13710.0,31,8,180.48,3,1,1,5
13711.0,218,13,252.06,1,1,1,3
13712.0,246,10,228.84,1,1,1,3
13715.0,280,105,1079.34,1,4,3,8
13716.0,268,21,138.28,1,2,1,4
13717.0,31,102,1445.01,3,4,3,10
13718.0,245,12,306.55,1,1,1,3
13719.0,14,60,1041.68,4,3,3,10
13720.0,116,43,799.9,2,3,3,8
13721.0,35,28,524.14,3,2,2,7
13722.0,131,85,2375.41,2,3,4,9
13723.0,216,6,199.85000000000002,1,1,1,3
13725.0,49,104,1980.56,3,4,4,11
13726.0,38,42,1079.6599999999999,3,3,3,9
13727.0,28,20,333.48,3,2,2,7
13728.0,36,63,1016.14,3,3,3,9
13730.0,135,43,752.6,2,3,3,8
13731.0,218,38,610.59,1,2,2,5
13732.0,27,33,491.86,3,2,2,7
13735.0,24,196,2885.2400000000002,3,4,4,11
13736.0,4,191,731.9,4,4,3,11
13737.0,199,30,339.59999999999997,1,2,2,5
13739.0,17,3,216.9,4,1,1,6
13740.0,240,23,350.75,1,2,2,5
13741.0,71,34,668.4300000000001,2,2,2,6
13742.0,16,321,3131.02,4,4,4,12
13743.0,2,41,1341.6,4,2,3,9
13744.0,94,72,1156.36,2,3,3,8
13745.0,161,25,300.04,1,2,1,4
13747.0,373,1,79.6,1,1,1,3
13748.0,95,28,948.25,2,2,3,7
13750.0,53,24,1647.26,2,2,3,7
13751.0,287,9,296.25,1,1,1,3
13752.0,123,76,1186.28,2,3,3,8
13753.0,287,35,741.26,1,2,3,6
13754.0,151,12,282.59999999999997,1,1,1,3
13755.0,3,342,2161.35,4,4,4,12
13756.0,1,142,5189.52,4,4,4,12
13758.0,11,117,3190.55,4,4,4,12
13759.0,32,25,659.4100000000001,3,2,2,7
13760.0,53,57,286.79,2,3,1,6
13761.0,49,70,1070.65,3,3,3,9
13762.0,218,7,306.72,1,1,1,3
13763.0,62,15,1714.96,2,1,4,7
13764.0,70,208,1521.76,2,4,3,9
13767.0,1,368,17220.36,4,4,4,12
13769.0,1,135,2796.51,4,4,4,12
13771.0,63,119,2634.45,2,4,4,10
13772.0,33,177,1132.13,3,4,3,10
13774.0,81,22,345.0,2,2,2,6
13777.0,0,197,25977.16,4,4,4,12
13778.0,102,9,178.7,2,1,1,4
13780.0,6,57,360.01,4,3,2,9
13781.0,250,17,127.84,1,1,1,3
13782.0,12,115,912.0,4,4,3,11
13784.0,9,31,2462.79,4,2,4,10
13786.0,366,7,230.39999999999998,1,1,1,3
13787.0,75,31,309.04,2,2,2,6
13790.0,3,45,348.8,4,3,2,9
13791.0,127,11,1516.0,2,1,3,6
13792.0,65,13,195.55,2,1,1,4
13798.0,0,349,37153.85,4,4,4,12
13799.0,116,39,688.86,2,2,3,7
13800.0,309,33,558.32,1,2,2,5
13801.0,66,23,324.8,2,2,2,6
13802.0,138,60,4599.42,2,3,4,9
13803.0,254,17,277.07,1,1,1,3
13804.0,30,137,2635.79,3,4,4,11
13805.0,51,13,924.6,2,1,3,6
13806.0,63,10,256.38,2,1,1,4
13807.0,366,7,112.6,1,1,1,3
13808.0,5,76,1747.66,4,3,4,11
13809.0,304,12,155.05,1,1,1,3
13810.0,28,35,1499.01,3,2,3,8
13811.0,183,13,814.5,1,1,3,5
13812.0,41,36,539.0,3,2,2,7
13813.0,39,69,1366.8600000000001,3,3,3,9
13814.0,91,57,1579.12,2,3,3,8
13815.0,21,176,4027.36,3,4,4,11
13816.0,23,28,571.6700000000001,3,2,2,7
13817.0,28,24,382.98,3,2,2,7
13819.0,301,36,1140.35,1,2,3,6
13821.0,144,59,385.64,1,3,2,6
13822.0,5,96,632.0,4,3,2,9
13823.0,18,40,957.66,3,2,3,8
13824.0,32,46,1698.94,3,3,4,10
13826.0,175,10,189.5,1,1,1,3
13827.0,57,93,412.05,2,3,2,7
13828.0,21,15,209.49,3,1,1,5
13831.0,15,74,2202.99,4,3,4,11
13832.0,18,3,52.199999999999996,3,1,1,5
13833.0,158,29,384.8,1,2,2,5
13835.0,24,55,834.57,3,3,3,9
13837.0,211,19,271.24,1,2,1,4
13838.0,5,174,691.73,4,4,3,11
13841.0,252,1,85.0,1,1,1,3
13842.0,58,206,3385.62,2,4,4,10
13844.0,10,20,361.62,4,2,2,8
13845.0,64,9,312.98,2,1,2,5
13846.0,24,55,865.0600000000001,3,3,3,9
13848.0,91,5,1255.0,2,1,3,6
13849.0,51,101,1537.95,2,4,3,9
13850.0,128,93,1595.48,2,3,3,8
13851.0,95,81,2651.46,2,3,4,9
13853.0,56,23,1090.14,2,2,3,7
13854.0,8,110,8109.5199999999995,4,4,4,12
13856.0,168,14,388.5,1,1,2,4
13858.0,56,11,216.17,2,1,1,4
13859.0,325,28,201.16,1,2,1,4
13860.0,0,76,1245.9,4,3,3,10
13862.0,17,139,2209.36,4,4,4,12
13863.0,247,20,305.78,1,2,1,4
13865.0,57,30,501.56,2,2,2,6
13866.0,73,7,145.67000000000002,2,1,1,4
13867.0,30,61,1015.29,3,3,3,9
13868.0,6,33,3192.54,4,2,4,10
13869.0,122,307,3104.95,2,4,4,10
13870.0,1,115,2770.94,4,4,4,12
13871.0,22,336,6403.25,3,4,4,11
13873.0,119,23,389.6,2,2,2,6
13874.0,357,18,540.45,1,2,2,5
13875.0,53,104,1786.79,2,4,4,10
13876.0,63,7,122.7,2,1,1,4
13877.0,85,3,117.24,2,1,1,4
13878.0,54,36,1281.53,2,2,3,7
13880.0,20,165,3219.77,3,4,4,11
13881.0,3,178,17159.52,4,4,4,12
13882.0,2,65,1191.13,4,3,3,10
13883.0,10,142,2674.48,4,4,4,12
13884.0,6,59,787.6,4,3,3,10
13885.0,188,28,506.8,1,2,2,5
13886.0,70,16,243.56,2,1,1,4
13887.0,203,19,349.55,1,2,2,5
13888.0,119,40,605.63,2,2,2,6
13889.0,92,15,416.90000000000003,2,1,2,5
13890.0,0,110,1883.8100000000002,4,4,4,12
13892.0,26,27,632.97,3,2,2,7
13893.0,297,21,821.1,1,2,3,6
13894.0,23,27,564.62,3,2,2,7
13895.0,27,118,2593.07,3,4,4,11
13897.0,49,17,311.16,3,1,2,6
13898.0,325,12,155.93,1,1,1,3
13899.0,15,19,388.52,4,2,2,8
13900.0,182,43,740.95,1,3,3,7
13901.0,71,149,2867.2,2,4,4,10
13904.0,36,26,332.64,3,2,2,7
13908.0,79,122,2369.55,2,4,4,10
13911.0,56,148,2580.91,2,4,4,10
13914.0,11,33,626.45,4,2,2,8
13917.0,49,18,272.04,3,2,1,6
13918.0,49,30,1212.8400000000001,3,2,3,8
13919.0,58,28,384.81,2,2,2,6
13922.0,351,7,172.25,1,1,1,3
13923.0,53,20,351.13,2,2,2,6
13924.0,1,117,1838.8500000000001,4,4,4,12
13925.0,92,41,678.25,2,2,3,7
13926.0,22,11,223.85000000000002,3,1,1,5
13927.0,74,21,348.99,2,2,2,6
13928.0,10,27,464.57,4,2,2,8
13929.0,168,9,842.65,1,1,3,5
13930.0,57,17,337.34,2,1,2,5
13931.0,95,58,1237.53,2,3,3,8
13932.0,294,16,307.4,1,1,2,4
13933.0,108,23,608.7900000000001,2,2,2,6
13934.0,263,31,922.1,1,2,3,6
13936.0,179,26,376.58,1,2,2,5
13937.0,168,9,158.85,1,1,1,3
13938.0,34,7,71.66,3,1,1,5
13939.0,22,45,568.55,3,3,2,8
13940.0,16,49,839.14,4,3,3,10
13941.0,21,45,5112.96,3,3,4,10
13946.0,78,11,561.5699999999999,2,1,2,5
13947.0,64,5,90.6,2,1,1,4
13948.0,360,3,102.0,1,1,1,3
13949.0,2,160,2427.32,4,4,4,12
13950.0,10,35,745.06,4,2,3,9
13951.0,175,39,674.45,1,2,2,5
13952.0,217,137,3251.071,1,4,4,9
13953.0,6,20,3515.68,4,2,4,10
13954.0,1,25,439.92,4,2,2,8
13955.0,153,33,322.96,1,2,2,5
13956.0,4,152,1026.42,4,4,3,11
13959.0,78,92,598.2,2,3,2,7
13960.0,20,12,230.22,3,1,1,5
13962.0,21,11,169.55,3,1,1,5
13963.0,307,35,664.54,1,2,2,5
13967.0,145,2,80.7,1,1,1,3
13969.0,6,626,9053.94,4,4,4,12
13971.0,18,149,2758.26,3,4,4,11
13972.0,70,15,190.25,2,1,1,4
13973.0,286,11,264.7,1,1,1,3
13974.0,48,28,413.59000000000003,3,2,2,7
13975.0,30,338,2526.28,3,4,4,11
13976.0,206,10,357.98,1,1,2,4
13978.0,14,15,196.79000000000002,4,1,1,6
13979.0,72,54,869.87,2,3,3,8
13980.0,59,11,200.14,2,1,1,4
13982.0,38,111,1871.81,3,4,4,11
13983.0,29,107,2603.43,3,4,4,11
13984.0,26,16,920.51,3,1,3,7
13985.0,3,351,7060.13,4,4,4,12
13986.0,16,13,320.46,4,1,2,7
13988.0,19,234,4147.96,3,4,4,11
13989.0,65,41,1266.08,2,2,3,7
13990.0,212,16,311.3,1,1,2,4
13991.0,11,84,855.97,4,3,3,10
13992.0,29,5,76.8,3,1,1,5
13993.0,42,121,3466.36,3,4,4,11
13994.0,3,155,2313.14,4,4,4,12
13995.0,14,86,1393.69,4,3,3,10
13999.0,9,208,3901.81,4,4,4,12
14000.0,210,15,635.66,1,1,2,4
14001.0,45,39,2043.0800000000002,3,2,4,9
14002.0,133,47,529.73,2,3,2,7
14004.0,42,171,4582.64,3,4,4,11
14005.0,9,84,2874.72,4,3,4,11
14006.0,115,30,962.19,2,2,3,7
14009.0,197,42,695.61,1,3,3,7
14012.0,277,11,328.8,1,1,2,4
14013.0,109,34,473.02,2,2,2,6
14014.0,76,39,505.18,2,2,2,6
14015.0,52,20,917.34,2,2,3,7
14016.0,161,161,4341.21,1,4,4,9
14019.0,46,66,1421.61,3,3,3,9
14020.0,16,39,642.8,4,2,2,8
14021.0,154,22,631.9,1,2,2,5
14022.0,224,28,440.0,1,2,2,5
14023.0,6,31,584.07,4,2,2,8
14024.0,121,16,327.7,2,1,2,5
14027.0,60,6,104.82,2,1,1,4
14029.0,62,15,467.66,2,1,2,5
14030.0,17,243,2360.09,4,4,4,12
14031.0,6,250,17286.86,4,4,4,12
14032.0,1,143,2975.59,4,4,4,12
14034.0,21,89,651.8199999999999,3,3,2,8
14035.0,28,66,1428.02,3,3,3,9
14036.0,284,38,626.65,1,2,2,5
14037.0,175,28,147.20000000000002,1,2,1,4
14038.0,77,92,1560.38,2,3,3,8
14039.0,32,6,152.2,3,1,1,5
14040.0,40,235,3614.92,3,4,4,11
14041.0,265,21,141.41,1,2,1,4
14044.0,26,209,652.82,3,4,2,9
14045.0,108,6,1659.75,2,1,3,6
14046.0,283,14,154.99,1,1,1,3
14047.0,8,32,1308.6100000000001,4,2,3,9
14048.0,304,85,409.93,1,3,2,6
14049.0,16,488,5681.72,4,4,4,12
14050.0,31,54,746.36,3,3,3,9
14051.0,0,210,15610.390000000001,4,4,4,12
14052.0,19,56,225.36,3,3,1,7
14053.0,123,4,260.25,2,1,1,4
14054.0,64,6,92.46,2,1,1,4
14055.0,105,10,725.6400000000001,2,1,3,6
14056.0,0,1106,8214.65,4,4,4,12
14057.0,23,284,6217.96,3,4,4,11
14059.0,266,8,183.6,1,1,1,3
14060.0,4,202,6140.42,4,4,4,12
14062.0,9,111,10464.85,4,4,4,12
14064.0,28,80,1353.74,3,3,3,9
14066.0,266,7,152.55,1,1,1,3
14067.0,63,52,374.7,2,3,2,7
14068.0,319,24,265.85,1,2,1,4
14071.0,3,324,1438.82,4,4,3,11
14073.0,31,13,151.04,3,1,1,5
14075.0,4,43,942.26,4,3,3,10
14076.0,128,46,122.47,2,3,1,6
14077.0,40,42,499.41999999999996,3,3,2,8
14078.0,101,65,1049.37,2,3,3,8
14079.0,124,12,375.1,2,1,2,5
14080.0,32,4,45.599999999999994,3,1,1,5
14081.0,301,153,934.52,1,4,3,8
14082.0,364,29,182.25,1,2,1,4
14083.0,3,181,1018.43,4,4,3,11
14085.0,1,450,4448.54,4,4,4,12
14087.0,2,69,194.42,4,3,1,8
14088.0,9,589,50491.81,4,4,4,12
14089.0,56,14,161.0,2,1,1,4
14090.0,324,1,76.32000000000001,1,1,1,3
14092.0,7,214,4076.91,4,4,4,12
14093.0,11,105,442.85,4,4,2,10
14096.0,3,5111,65164.79,4,4,4,12
14098.0,36,21,147.35,3,2,1,6
14099.0,15,250,3104.17,4,4,4,12
14100.0,137,26,194.9,2,2,1,5
14101.0,73,35,5976.79,2,2,4,8
14102.0,4,79,1360.28,4,3,3,10
14104.0,154,21,216.20999999999998,1,2,1,4
14105.0,238,74,1266.23,1,3,3,7
14107.0,51,123,2703.23,2,4,4,10
14108.0,30,34,597.91,3,2,2,7
14109.0,72,9,144.2,2,1,1,4
14110.0,3,156,5683.15,4,4,4,12
14111.0,13,10,692.85,4,1,3,8
14112.0,22,160,2915.15,3,4,4,11
14113.0,3,34,1840.42,4,2,4,10
14114.0,273,15,386.53,1,1,2,4
14116.0,19,72,1382.74,3,3,3,9
14117.0,143,3,90.0,1,1,1,3
14121.0,3,159,2780.15,4,4,4,12
14124.0,83,5,419.58000000000004,2,1,2,5
14125.0,10,167,2740.43,4,4,4,12
14126.0,7,15,706.1300000000001,4,1,3,8
14127.0,122,44,709.71,2,3,3,8
14128.0,60,46,637.5,2,3,2,7
14129.0,1,52,1123.8600000000001,4,3,3,10
14130.0,318,67,483.86,1,3,2,6
14132.0,1,200,3586.0299999999997,4,4,4,12
14133.0,129,28,605.64,2,2,2,6
14135.0,1,134,4690.31,4,4,4,12
14138.0,1,47,982.3800000000001,4,3,3,10
14139.0,45,26,415.82,3,2,2,7
14140.0,3,66,935.05,4,3,3,10
14141.0,2,40,915.13,4,2,3,9
14142.0,372,22,311.81,1,2,2,5
14143.0,133,7,115.8,2,1,1,4
14145.0,46,11,3742.2,3,1,4,8
14146.0,8,210,4191.0,4,4,4,12
14147.0,77,5,483.4,2,1,2,5
14148.0,233,3,157.2,1,1,1,3
14149.0,220,28,446.62,1,2,2,5
14150.0,35,26,658.64,3,2,2,7
14152.0,74,49,621.29,2,3,2,7
14154.0,238,52,1345.62,1,3,3,7
14155.0,265,6,118.75,1,1,1,3
14156.0,9,1400,117379.63,4,4,4,12
14157.0,19,48,432.88,3,3,2,8
14158.0,39,41,507.66,3,2,2,7
14159.0,19,1204,4693.01,3,4,4,11
14161.0,215,108,1110.52,1,4,3,8
14162.0,173,25,289.36,1,2,1,4
14163.0,86,52,2445.91,2,3,4,9
14164.0,70,29,1631.77,2,2,3,7
14165.0,275,25,122.53999999999999,1,2,1,4
14167.0,38,52,574.84,3,3,2,8
14171.0,97,58,363.79,2,3,2,7
14173.0,10,29,450.84,4,2,2,8
14174.0,32,26,134.46,3,2,1,6
14175.0,59,149,3222.3,2,4,4,10
14176.0,296,31,576.9000000000001,1,2,2,5
14177.0,85,42,559.41,2,3,2,7
14178.0,8,327,1620.93,4,4,3,11
14179.0,40,165,719.78,3,4,3,10
14180.0,10,240,4748.52,4,4,4,12
14184.0,66,24,452.89,2,2,2,6
14185.0,330,3,197.65,1,1,1,3
14188.0,30,65,2054.36,3,3,4,10
14189.0,1,265,4654.08,4,4,4,12
14191.0,1,259,4684.76,4,4,4,12
14193.0,67,42,853.39,2,3,3,8
14194.0,4,579,11349.52,4,4,4,12
14195.0,201,7,1012.0,1,1,3,5
14196.0,106,6,335.52,2,1,2,5
14198.0,17,39,701.4,4,2,3,9
14199.0,217,2,185.39999999999998,1,1,1,3
14201.0,59,37,747.44,2,2,3,7
14204.0,1,44,161.03,4,3,1,8
14205.0,16,24,466.7,4,2,2,8
14206.0,238,20,328.15999999999997,1,2,2,5
14208.0,94,10,151.74,2,1,1,4
14209.0,10,87,2073.43,4,3,4,11
14210.0,105,102,1905.8400000000001,2,4,4,10
14211.0,52,112,2241.1,2,4,4,10
14212.0,89,9,1070.48,2,1,3,6
14214.0,30,67,1004.38,3,3,3,9
14215.0,11,108,1789.72,4,4,4,12
14216.0,2,59,1839.3,4,3,4,11
14217.0,1,100,2004.98,4,3,4,11
14218.0,42,12,169.48000000000002,3,1,1,5
14219.0,3,7,89.94,4,1,1,6
14220.0,246,21,632.4,1,2,2,5
14221.0,41,193,3432.8,3,4,4,11
14222.0,176,41,683.17,1,2,3,6
14223.0,91,60,991.13,2,3,3,8
14224.0,109,118,1050.12,2,4,3,9
14226.0,28,67,2232.19,3,3,4,10
14227.0,25,175,3350.96,3,4,4,11
14229.0,51,40,1547.2,2,2,3,7
14231.0,183,50,925.71,1,3,3,7
14232.0,42,115,2048.07,3,4,4,11
14233.0,48,35,1462.72,3,2,3,8
14234.0,21,159,775.46,3,4,3,10
14235.0,74,79,3144.86,2,3,4,9
14236.0,80,15,490.86,2,1,2,5
14237.0,372,9,161.0,1,1,1,3
14238.0,325,8,146.85,1,1,1,3
14239.0,42,112,2380.85,3,4,4,11
14240.0,29,42,890.34,3,3,3,9
14241.0,183,10,213.70000000000002,1,1,1,3
14242.0,234,16,280.55,1,1,1,3
14243.0,8,141,2588.77,4,4,4,12
14245.0,219,108,1693.45,1,4,4,9
14246.0,110,75,1474.06,2,3,3,8
14247.0,277,20,136.76999999999998,1,2,1,4
14248.0,317,8,302.58,1,1,1,3
14250.0,6,111,1904.05,4,4,4,12
14251.0,1,78,2879.7000000000003,4,3,4,11
14256.0,259,53,969.0600000000001,1,3,3,7
14257.0,63,106,3099.7200000000003,2,4,4,10
14258.0,8,111,12669.98,4,4,4,12
14259.0,141,5,120.0,2,1,1,4
14261.0,50,52,1163.45,3,3,3,9
14262.0,7,143,2618.23,4,4,4,12
14264.0,154,17,333.97,1,1,2,4
14265.0,108,31,530.18,2,2,2,6
14267.0,162,55,1516.24,1,3,3,7
14270.0,331,29,492.65000000000003,1,2,2,5
14271.0,225,10,112.32,1,1,1,3
14272.0,73,33,437.96,2,2,2,6
14273.0,50,29,559.97,3,2,2,7
14276.0,98,64,1119.74,2,3,3,8
14277.0,14,225,4216.2,4,4,4,12
14280.0,196,8,134.04,1,1,1,3
14282.0,2,156,3729.34,4,4,4,12
14284.0,30,32,595.25,3,2,2,7
14285.0,20,27,1910.01,3,2,4,9
14286.0,23,280,4628.75,3,4,4,11
14287.0,7,9,176.63,4,1,1,6
14288.0,212,16,426.6,1,1,2,4
14289.0,8,47,911.26,4,3,3,10
14290.0,10,101,2314.65,4,4,4,12
14291.0,1,237,3883.25,4,4,4,12
14292.0,7,100,4871.93,4,3,4,11
14293.0,2,61,1046.56,4,3,3,10
14295.0,39,5,166.20000000000002,3,1,1,5
14297.0,17,62,1305.33,4,3,3,10
14298.0,7,1637,51527.3,4,4,4,12
14299.0,7,143,3965.62,4,4,4,12
14300.0,18,3,43.2,3,1,1,5
14301.0,116,13,640.14,2,1,2,5
14304.0,222,17,383.45,1,1,2,4
14305.0,70,105,1858.96,2,4,4,10
14306.0,50,33,2093.32,3,2,4,9
14307.0,88,180,2995.72,2,4,4,10
14309.0,7,117,2352.53,4,4,4,12
14311.0,242,20,310.26,1,2,2,5
14312.0,46,87,1611.59,3,3,3,9
14314.0,106,8,120.0,2,1,1,4
14315.0,44,101,2481.13,3,4,4,11
14317.0,64,24,508.58000000000004,2,2,2,6
14320.0,206,31,477.79,1,2,2,5
14321.0,10,123,1530.75,4,4,3,11
14323.0,114,36,605.0600000000001,2,2,2,6
14326.0,241,8,183.85,1,1,1,3
14327.0,162,12,311.65,1,1,2,4
14329.0,16,259,5014.84,4,4,4,12
14331.0,123,28,462.65999999999997,2,2,2,6
14332.0,22,26,866.31,3,2,3,8
14333.0,67,15,415.2,2,1,2,5
14334.0,16,162,2552.21,4,4,4,12
14335.0,15,63,468.26,4,3,2,9
14336.0,16,90,1614.91,4,3,3,10
14338.0,160,31,588.22,1,2,2,5
14339.0,242,14,309.52,1,1,2,4
14340.0,218,6,134.7,1,1,1,3
14341.0,44,129,2182.28,3,4,4,11
14342.0,20,21,668.5600000000001,3,2,2,7
14344.0,126,71,889.9300000000001,2,3,3,8
14345.0,38,6,108.97999999999999,3,1,1,5
14346.0,120,60,1021.58,2,3,3,8
14348.0,259,18,409.57,1,2,2,5
14349.0,9,31,133.5,4,2,1,7
14350.0,273,18,282.93,1,2,1,4
14351.0,164,1,51.0,1,1,1,3
14352.0,156,47,1078.96,1,3,3,7
14353.0,214,6,90.6,1,1,1,3
14354.0,5,9,163.62,4,1,1,6
14355.0,365,11,174.4,1,1,1,3
14356.0,79,33,701.23,2,2,3,7
14357.0,42,41,225.77,3,2,1,6
14359.0,18,55,912.18,3,3,3,9
14360.0,31,118,2128.23,3,4,4,11
14362.0,21,41,161.2,3,2,1,6
14364.0,108,69,3717.35,2,3,4,9
14367.0,7,524,9261.52,4,4,4,12
14368.0,319,8,155.0,1,1,1,3
14371.0,294,4,100.5,1,1,1,3
14373.0,357,4,76.55,1,1,1,3
14375.0,184,75,257.68,1,3,1,5
14377.0,190,11,617.05,1,1,2,4
14379.0,43,46,348.1,3,3,2,8
14381.0,51,56,202.68,2,3,1,6
14382.0,25,131,626.0699999999999,3,4,2,9
14383.0,37,59,1247.69,3,3,3,9
14385.0,8,14,202.11,4,1,1,6
14386.0,296,7,142.4,1,1,1,3
14387.0,32,140,1770.56,3,4,4,11
14388.0,9,186,3212.84,4,4,4,12
14389.0,64,45,1043.46,2,3,3,8
14390.0,9,286,4652.82,4,4,4,12
14393.0,217,5,67.95,1,1,1,3
14395.0,1,350,3507.71,4,4,4,12
14396.0,64,73,487.99,2,3,2,7
14397.0,2,87,2612.96,4,3,4,11
14400.0,148,25,574.7,1,2,2,5
14401.0,3,182,4051.48,4,4,4,12
14403.0,129,20,1475.81,2,2,3,7
14404.0,33,103,1474.32,3,4,3,10
14406.0,118,8,156.75,2,1,1,4
14407.0,106,73,2157.73,2,3,4,9
14408.0,10,107,2606.53,4,4,4,12
14409.0,70,54,2059.4500000000003,2,3,4,9
14410.0,91,194,1105.07,2,4,3,9
14411.0,310,14,1063.0,1,1,3,5
14412.0,42,43,770.03,3,3,3,9
14413.0,361,23,122.7,1,2,1,4
14414.0,91,97,1496.98,2,3,3,8
14415.0,0,590,5900.28,4,4,4,12
14416.0,21,14,490.22,3,1,2,6
14418.0,3,124,1937.25,4,4,4,12
14419.0,10,206,1058.06,4,4,3,11
14420.0,98,29,387.52,2,2,2,6
14421.0,56,27,813.11,2,2,3,7
14422.0,0,222,4263.64,4,4,4,12
14423.0,217,3,265.2,1,1,1,3
14424.0,17,1,322.08,4,1,2,7
14426.0,23,224,4481.67,3,4,4,11
14427.0,49,17,363.34000000000003,3,1,2,6
14428.0,6,144,1244.83,4,4,3,11
14431.0,302,17,470.36,1,1,2,4
14432.0,9,382,2255.51,4,4,4,12
14434.0,21,12,1372.8,3,1,3,7
14436.0,98,9,89.06,2,1,1,4
14437.0,365,5,63.0,1,1,1,3
14438.0,305,9,131.9,1,1,1,3
14439.0,319,32,2661.24,1,2,4,7
14440.0,7,55,2357.6800000000003,4,3,4,11
14441.0,0,51,1712.89,4,3,4,11
14442.0,204,63,1589.82,1,3,3,7
14443.0,53,93,1420.2,2,3,3,8
14446.0,0,293,1039.58,4,4,3,11
14447.0,18,70,1163.23,3,3,3,9
14448.0,8,20,375.35,4,2,2,8
14449.0,18,258,907.1,3,4,3,10
14450.0,180,40,483.25,1,2,2,5
14451.0,59,109,662.59,2,4,2,8
14452.0,10,62,264.44,4,3,1,8
14453.0,189,22,119.93,1,2,1,4
14456.0,4,970,3062.4,4,4,4,12
14457.0,310,4,113.64,1,1,1,3
14459.0,154,37,1837.92,1,2,4,7
14460.0,109,16,434.34,2,1,2,5
14461.0,147,180,2103.06,1,4,4,9
14462.0,65,240,2004.02,2,4,4,10
14463.0,97,6,529.62,2,1,2,5
14465.0,246,130,1058.6200000000001,1,4,3,8
14466.0,28,72,2272.4,3,3,4,10
14467.0,17,90,598.76,4,3,2,9
14470.0,11,43,461.19,4,3,2,9
14472.0,103,281,1936.84,2,4,4,10
14473.0,73,7,234.34000000000003,2,1,1,4
14474.0,45,29,547.66,3,2,2,7
14475.0,71,42,925.85,2,3,3,8
14476.0,256,19,215.7,1,2,1,4
14477.0,19,10,1309.6,3,1,3,7
14479.0,253,18,316.25,1,2,2,5
14480.0,10,13,279.05,4,1,1,6
14481.0,164,30,636.51,1,2,2,5
14482.0,17,144,2068.15,4,4,4,12
14483.0,281,9,137.1,1,1,1,3
14484.0,49,14,321.92,3,1,2,6
14485.0,38,47,165.75,3,3,1,7
14487.0,26,144,1196.33,3,4,3,10
14488.0,67,46,1064.28,2,3,3,8
14489.0,206,30,463.38,1,2,2,5
14491.0,174,17,340.93,1,1,2,4
14493.0,6,120,2383.2400000000002,4,4,4,12
14494.0,25,7,139.56,3,1,1,5
14495.0,50,6,123.8,3,1,1,5
14496.0,311,19,538.8100000000001,1,2,2,5
14497.0,308,29,475.37,1,2,2,5
14498.0,42,193,1957.32,3,4,4,11
14499.0,25,194,815.32,3,4,3,10
14500.0,87,7,356.85,2,1,2,5
14501.0,183,10,251.21,1,1,1,3
14502.0,19,624,2470.67,3,4,4,11
14503.0,2,164,3543.26,4,4,4,12
14504.0,46,107,673.26,3,4,2,9
14505.0,16,799,5905.64,4,4,4,12
14506.0,16,316,2012.17,4,4,4,12
14507.0,23,96,1383.18,3,3,3,9
14508.0,21,57,276.42,3,3,1,7
14511.0,10,68,1314.81,4,3,3,10
14512.0,187,23,275.28,1,2,1,4
14513.0,100,12,455.59000000000003,2,1,2,5
14514.0,60,73,1055.35,2,3,3,8
14515.0,17,101,2102.09,4,4,4,12
14517.0,32,18,330.45,3,2,2,7
14518.0,63,16,174.37,2,1,1,4
14520.0,1,4,270.6,4,1,1,6
14522.0,23,17,974.54,3,1,3,7
14523.0,107,12,241.09,2,1,1,4
14524.0,31,203,1867.68,3,4,4,11
14525.0,19,291,4332.2,3,4,4,11
14527.0,2,972,8508.82,4,4,4,12
14528.0,36,18,364.21999999999997,3,2,2,7
14529.0,59,229,620.04,2,4,2,8
14530.0,25,216,2925.91,3,4,4,11
14532.0,235,64,932.85,1,3,3,7
14533.0,24,62,1949.72,3,3,4,10
14534.0,2,519,4447.05,4,4,4,12
14535.0,59,330,2864.19,2,4,4,10
14536.0,259,19,171.8,1,2,1,4
14537.0,57,10,355.56,2,1,2,5
14538.0,64,19,388.25,2,2,2,6
14539.0,15,32,537.48,4,2,2,8
14540.0,9,76,996.26,4,3,3,10
14541.0,58,111,1461.65,2,4,3,9
14542.0,185,5,103.25,1,1,1,3
14543.0,28,72,3630.33,3,3,4,10
14544.0,23,114,2024.45,3,4,4,11
14546.0,4,399,2578.09,4,4,4,12
14547.0,3,366,4007.54,4,4,4,12
14548.0,150,4,652.8,1,1,2,4
14549.0,310,56,289.24,1,3,1,5
14550.0,10,48,765.62,4,3,3,10
14551.0,17,10,186.23,4,1,1,6
14552.0,151,58,165.07,1,3,1,5
14553.0,18,113,859.27,3,4,3,10
14554.0,9,216,2381.04,4,4,4,12
14555.0,56,21,324.14,2,2,2,6
14557.0,84,16,788.38,2,1,3,6
14560.0,6,74,2237.77,4,3,4,11
14561.0,75,69,1080.76,2,3,3,8
14562.0,3,423,5074.77,4,4,4,12
14565.0,95,127,3099.12,2,4,4,10
14566.0,110,4,1432.0,2,1,3,6
14567.0,56,33,1530.3600000000001,2,2,3,7
14569.0,0,12,227.39,4,1,1,6
14570.0,280,29,218.06,1,2,1,4
14572.0,2,270,2832.84,4,4,4,12
14573.0,179,235,1653.42,1,4,3,8
14576.0,371,1,35.400000000000006,1,1,1,3
14577.0,12,123,859.71,4,4,3,11
14578.0,2,24,168.63,4,2,1,7
14581.0,16,17,138.6,4,1,1,6
14582.0,40,6,114.11,3,1,1,5
14583.0,5,330,1052.55,4,4,3,11
14584.0,168,100,1042.26,1,3,3,7
14585.0,49,29,157.05,3,2,1,6
14586.0,276,19,237.36,1,2,1,4
14587.0,18,383,1601.14,3,4,3,10
14589.0,371,3,39.75,1,1,1,3
14591.0,14,197,1447.14,4,4,3,11
14592.0,34,164,570.46,3,4,2,9
14593.0,21,152,617.99,3,4,2,9
14594.0,6,53,379.83,4,3,2,9
14595.0,19,102,1740.6,3,4,4,11
14597.0,10,55,883.15,4,3,3,10
14598.0,43,50,221.97,3,3,1,7
14600.0,305,25,393.33000000000004,1,2,2,5
14601.0,10,7,213.96,4,1,1,6
14603.0,274,2,660.0,1,1,2,4
14606.0,0,2700,12156.65,4,4,4,12
14607.0,15,86,16569.5,4,3,4,11
14608.0,3,20,1785.15,4,2,4,10
14609.0,71,4,601.56,2,1,2,5
14616.0,242,3,406.08000000000004,1,1,2,4
14618.0,8,16,553.44,4,1,2,7
14619.0,245,20,394.44,1,2,2,5
14620.0,205,26,412.78000000000003,1,2,2,5
14621.0,0,92,1788.3600000000001,4,3,4,11
14622.0,184,21,320.58000000000004,1,2,2,5
14623.0,31,134,889.25,3,4,3,10
14624.0,56,13,225.85,2,1,1,4
14625.0,195,53,899.63,1,3,3,7
14626.0,23,122,2791.27,3,4,4,11
14628.0,90,24,671.96,2,2,2,6
14629.0,3,152,959.01,4,4,3,11
14631.0,50,41,1006.98,3,2,3,8
14632.0,262,8,114.56,1,1,1,3
14633.0,265,20,344.90000000000003,1,2,2,5
14636.0,35,28,609.85,3,2,2,7
14638.0,50,16,443.6,3,1,2,6
14639.0,51,172,2984.49,2,4,4,10
14640.0,23,106,2125.08,3,4,4,11
14641.0,21,7,110.46,3,1,1,5
14642.0,58,2,96.12,2,1,1,4
14643.0,169,31,693.8100000000001,1,2,3,6
14644.0,67,26,830.76,2,2,3,7
14645.0,156,30,597.09,1,2,2,5
14646.0,1,2080,280206.02,4,4,4,12
14647.0,200,30,243.22,1,2,1,4
14649.0,4,199,1417.29,4,4,3,11
14651.0,66,102,654.6,2,4,2,8
14652.0,76,29,114.18,2,2,1,5
14653.0,0,237,1947.55,4,4,4,12
14655.0,7,49,1932.23,4,3,4,11
14656.0,168,80,291.05,1,3,1,5
14657.0,17,126,848.22,4,4,3,11
14658.0,4,29,247.15,4,2,1,7
14659.0,8,253,2529.93,4,4,4,12
14660.0,86,30,285.74,2,2,1,5
14661.0,26,4,107.95,3,1,1,5
14662.0,28,168,771.17,3,4,3,10
14664.0,19,99,637.89,3,3,2,8
14665.0,60,90,1835.7,2,3,4,9
14666.0,23,14,195.25,3,1,1,5
14667.0,10,573,9241.2,4,4,4,12
14669.0,241,170,1269.99,1,4,3,8
14670.0,279,132,411.53,1,4,2,7
14672.0,234,61,765.55,1,3,3,7
14673.0,2,74,1736.4,4,3,4,11
14675.0,15,102,604.75,4,4,2,10
14676.0,30,42,2548.2400000000002,3,3,4,10
14680.0,24,258,28754.11,3,4,4,11
14681.0,70,7,498.95,2,1,2,5
14682.0,187,2,52.0,1,1,1,3
14684.0,25,421,1236.28,3,4,3,10
14687.0,106,15,628.38,2,1,2,5
14688.0,7,327,5630.87,4,4,4,12
14689.0,208,13,112.8,1,1,1,3
14690.0,43,50,371.7,3,3,2,8
14691.0,30,71,2114.33,3,3,4,10
14692.0,136,68,591.55,2,3,2,7
14693.0,264,8,172.9,1,1,1,3
14696.0,3,130,2078.95,4,4,4,12
14697.0,217,22,188.60999999999999,1,2,1,4
14698.0,1,210,1250.76,4,4,3,11
14699.0,213,8,109.13000000000001,1,1,1,3
14700.0,31,115,2235.3,3,4,4,11
14701.0,10,335,2549.37,4,4,4,12
14702.0,0,347,3292.14,4,4,4,12
14703.0,14,22,318.17,4,2,2,8
14704.0,10,415,1546.91,4,4,3,11
14705.0,198,1,179.0,1,1,1,3
14708.0,2,28,1126.37,4,2,3,9
14709.0,14,196,4921.04,4,4,4,12
14710.0,13,139,606.13,4,4,2,10
14711.0,9,357,2868.8,4,4,4,12
14712.0,28,25,917.07,3,2,3,8
14713.0,8,339,2666.36,4,4,4,12
14714.0,23,10,160.19,3,1,1,5
14715.0,24,71,867.38,3,3,3,9
14716.0,42,55,329.68,3,3,2,8
14719.0,1,237,1602.13,4,4,3,11
14720.0,5,37,663.81,4,2,2,8
14722.0,146,29,187.92000000000002,1,2,1,4
14723.0,9,278,1158.3,4,4,3,11
14725.0,24,52,718.08,3,3,3,9
14727.0,273,10,268.58,1,1,1,3
14729.0,373,71,313.49,1,3,2,6
14730.0,0,501,2005.06,4,4,4,12
14731.0,46,45,380.02,3,3,2,8
14732.0,7,147,2702.4900000000002,4,4,4,12
14733.0,15,202,9585.91,4,4,4,12
14735.0,3,194,6065.69,4,4,4,12
14737.0,3,17,1164.55,4,1,3,8
14738.0,42,54,1314.45,3,3,3,9
14739.0,3,60,3902.28,4,3,4,11
14740.0,196,89,1448.21,1,3,3,7
14741.0,11,59,1400.34,4,3,3,10
14744.0,15,26,1099.98,4,2,3,9
14745.0,112,69,1220.26,2,3,3,8
14747.0,248,18,328.2,1,2,2,5
14748.0,28,89,1415.75,3,3,3,9
14752.0,43,5,389.64,3,1,2,6
14753.0,86,30,563.15,2,2,2,6
14754.0,44,41,638.05,3,2,2,7
14755.0,9,235,5010.28,4,4,4,12
14756.0,14,38,738.96,4,2,3,9
14757.0,74,19,420.5,2,2,2,6
14758.0,144,71,1484.06,1,3,3,7
14759.0,4,102,1625.97,4,4,3,11
14760.0,296,5,89.2,1,1,1,3
14761.0,58,11,255.9,2,1,1,4
14762.0,263,21,300.52,1,2,1,4
14764.0,46,6,278.3,3,1,1,5
14765.0,28,39,254.11,3,2,1,6
14766.0,7,135,2473.37,4,4,4,12
14768.0,16,5,192.60000000000002,4,1,1,6
14769.0,2,1090,10674.75,4,4,4,12
14770.0,231,52,876.42,1,3,3,7
14772.0,111,9,139.26,2,1,1,4
14775.0,57,60,1011.9,2,3,3,8
14776.0,50,117,2538.3,3,4,4,11
14778.0,126,35,730.86,2,2,3,7
14779.0,280,41,386.15,1,2,2,5
14780.0,54,27,447.68,2,2,2,6
14782.0,319,6,200.10000000000002,1,1,1,3
14784.0,25,15,289.99,3,1,1,5
14785.0,9,3,77.4,4,1,1,6
14788.0,6,30,679.4399999999999,4,2,3,9
14789.0,28,6,197.64,3,1,1,5
14790.0,16,46,745.06,4,3,3,10
14792.0,63,2,6.2,2,1,1,4
14793.0,20,14,228.99,3,1,1,5
14794.0,2,80,1319.91,4,3,3,10
14795.0,165,6,131.45000000000002,1,1,1,3
14796.0,0,1141,8022.49,4,4,4,12
14798.0,52,12,173.74,2,1,1,4
14799.0,50,13,157.7,3,1,1,5
14800.0,47,385,4339.74,3,4,4,11
14801.0,60,59,193.14,2,3,1,6
14803.0,161,44,845.55,1,3,3,7
14804.0,8,12,353.27,4,1,2,7
14805.0,14,47,554.65,4,3,2,9
14806.0,74,11,193.39000000000001,2,1,1,4
14808.0,39,235,2741.17,3,4,4,11
14810.0,40,255,2087.88,3,4,4,11
14813.0,369,30,155.43,1,2,1,4
14815.0,36,53,778.5,3,3,3,9
14816.0,196,4,271.85,1,1,1,3
14817.0,199,63,1110.34,1,3,3,7
14818.0,73,48,657.8,2,3,2,7
14819.0,63,13,272.07,2,1,1,4
14820.0,20,29,507.29,3,2,2,7
14821.0,366,2,48.800000000000004,1,1,1,3
14823.0,179,70,321.43,1,3,2,6
14824.0,9,29,1127.71,4,2,3,9
14825.0,3,121,2226.91,4,4,4,12
14828.0,196,17,2139.76,1,1,4,6
14829.0,28,42,697.55,3,3,3,9
14830.0,52,40,197.13,2,2,1,5
14834.0,17,67,1720.3,4,3,4,11
14836.0,9,6,102.44999999999999,4,1,1,6
14837.0,89,108,1649.5,2,4,3,9
14840.0,267,4,62.85,1,1,1,3
14841.0,52,138,3295.76,2,4,4,10
14842.0,43,145,2824.69,3,4,4,11
14844.0,63,130,3189.81,2,4,4,10
14847.0,148,13,309.4,1,1,2,4
14849.0,21,388,7930.54,3,4,4,11
14850.0,311,21,325.75,1,2,2,5
14851.0,22,28,511.35,3,2,2,7
14852.0,57,143,2836.69,2,4,4,10
14853.0,23,9,475.8,3,1,2,6
14854.0,77,127,2759.83,2,4,4,10
14855.0,118,20,645.65,2,2,2,6
14856.0,35,66,1311.3799999999999,3,3,3,9
14857.0,59,60,1173.12,2,3,3,8
14859.0,12,58,1353.74,4,3,3,10
14860.0,18,11,170.32,3,1,1,5
14861.0,51,6,125.79,2,1,1,4
14862.0,25,48,841.1999999999999,3,3,3,9
14863.0,28,11,266.76,3,1,1,5
14865.0,6,4,52.2,4,1,1,6
14866.0,10,99,14389.9,4,3,4,11
14867.0,185,36,710.28,1,2,3,6
14868.0,2,144,2953.59,4,4,4,12
14869.0,8,71,725.7,4,3,3,10
14870.0,261,13,327.25,1,1,2,4
14871.0,2,98,522.38,4,3,2,9
14873.0,209,28,519.68,1,2,2,5
14875.0,107,47,1465.3200000000002,2,3,3,8
14878.0,12,124,1485.54,4,4,3,11
14880.0,76,47,706.19,2,3,3,8
14881.0,19,17,255.4,3,1,1,5
14882.0,26,11,589.7,3,1,2,6
14883.0,18,53,761.59,3,3,3,9
14885.0,131,15,765.3199999999999,2,1,3,6
14886.0,252,18,364.8,1,2,2,5
14887.0,78,6,1862.0,2,1,4,7
14888.0,206,20,369.2,1,2,2,5
14889.0,335,10,135.9,1,1,1,3
14890.0,253,7,125.65,1,1,1,3
14891.0,147,33,554.38,1,2,2,5
14893.0,9,73,1237.8500000000001,4,3,3,10
14894.0,84,23,655.75,2,2,2,6
14895.0,7,498,11138.710000000001,4,4,4,12
14896.0,204,43,468.77000000000004,1,3,2,6
14897.0,7,55,1366.38,4,3,3,10
14898.0,22,116,1303.52,3,4,3,10
14901.0,10,96,1421.29,4,3,3,10
14902.0,25,20,332.66,3,2,2,7
14903.0,20,355,2810.63,3,4,4,11
14904.0,1,69,1025.44,4,3,3,10
14905.0,157,17,616.15,1,1,2,4
14907.0,2,165,3501.1,4,4,4,12
14908.0,73,9,277.8,2,1,1,4
14910.0,2,30,434.35,4,2,2,8
14911.0,0,5677,143825.06,4,4,4,12
14912.0,16,27,867.85,4,2,3,9
14913.0,35,87,1227.43,3,3,3,9
14915.0,90,12,307.48,2,1,2,5
14916.0,70,77,1268.98,2,3,3,8
14918.0,115,45,1610.15,2,3,3,8
14920.0,212,57,977.77,1,3,3,7
14921.0,29,78,1316.07,3,3,3,9
14923.0,50,44,749.1,3,3,3,9
14924.0,245,10,310.05,1,1,2,4
14929.0,31,11,223.88,3,1,1,5
14930.0,108,128,2372.86,2,4,4,10
14931.0,4,41,1257.68,4,2,3,9
14932.0,365,17,363.53,1,1,2,4
14934.0,81,87,1890.94,2,3,4,9
14935.0,296,10,1784.71,1,1,4,6
14936.0,33,364,8137.02,3,4,4,11
14937.0,56,34,1621.88,2,2,3,7
14944.0,29,170,5900.25,3,4,4,11
14946.0,13,3,100.9,4,1,1,6
14947.0,71,14,290.82,2,1,1,4
14948.0,22,63,1101.97,3,3,3,9
14950.0,18,19,371.2,3,2,2,7
14951.0,78,20,311.69,2,2,2,6
14952.0,59,138,8099.49,2,4,4,10
14953.0,24,55,289.82,3,3,1,7
14954.0,11,85,336.17,4,3,2,9
14957.0,252,12,58.49,1,1,1,3
14958.0,146,42,499.68,1,3,2,6
14959.0,63,59,695.42,2,3,3,8
14960.0,7,27,221.27,4,2,1,7
14961.0,10,312,7044.68,4,4,4,12
14962.0,270,5,126.7,1,1,1,3
14963.0,9,198,1487.8,4,4,3,11
14964.0,246,13,206.21,1,1,1,3
14965.0,95,83,599.0,2,3,2,7
14966.0,14,38,191.32,4,2,1,7
14967.0,49,6,463.8,3,1,2,6
14968.0,29,37,147.59,3,2,1,6
14970.0,67,34,1592.06,2,2,3,7
14971.0,34,160,1116.57,3,4,3,10
14972.0,127,18,114.77,2,2,1,5
14973.0,106,32,1314.45,2,2,3,7
14974.0,36,21,114.39,3,2,1,6
14975.0,56,11,279.94,2,1,1,4
14976.0,56,72,790.86,2,3,3,8
14978.0,71,216,1931.42,2,4,4,10
14981.0,245,8,102.12,1,1,1,3
14984.0,18,41,213.27,3,2,1,6
14985.0,197,87,296.75,1,3,1,5
14987.0,15,4,326.4,4,1,2,7
14988.0,211,40,334.54,1,2,2,5
14995.0,38,61,233.23000000000002,3,3,1,7
14997.0,45,26,546.1999999999999,3,2,2,7
14998.0,169,75,429.87,1,3,2,6
15000.0,47,77,490.52,3,3,2,8
15002.0,115,115,1641.76,2,4,3,9
15004.0,146,158,1246.32,1,4,3,8
15005.0,15,1119,6316.57,4,4,4,12
15006.0,50,144,502.09,3,4,2,9
15007.0,158,12,156.91,1,1,1,3
15009.0,11,182,1261.78,4,4,3,11
15010.0,35,20,308.94,3,2,2,7
15012.0,53,128,423.04,2,4,2,8
15014.0,42,35,260.17,3,2,1,6
15016.0,172,20,170.04,1,2,1,4
15017.0,33,20,125.58,3,2,1,6
15018.0,38,31,496.21000000000004,3,2,2,7
15019.0,266,70,266.0,1,3,1,5
15021.0,8,472,1914.82,4,4,4,12
15022.0,11,135,905.04,4,4,3,11
15023.0,2,562,6802.76,4,4,4,12
15024.0,9,155,1661.33,4,4,3,11
15025.0,32,72,377.01,3,3,2,8
15026.0,79,61,469.0,2,3,2,7
15027.0,30,35,1066.1499999999999,3,2,3,8
15028.0,7,48,627.13,4,3,2,9
15030.0,71,7,518.28,2,1,2,5
15031.0,3,111,668.14,4,4,2,10
15032.0,255,52,4959.1,1,3,4,8
15033.0,4,510,2586.67,4,4,4,12
15034.0,15,394,4308.61,4,4,4,12
15035.0,89,27,252.73000000000002,2,2,1,5
15036.0,71,127,465.55,2,4,2,8
15038.0,58,130,705.49,2,4,3,9
15039.0,9,1502,19914.44,4,4,4,12
15041.0,169,67,180.35,1,3,1,5
15042.0,198,5,135.93,1,1,1,3
15043.0,30,3,537.0,3,1,2,6
15044.0,18,453,7700.2300000000005,3,4,4,11
15045.0,151,12,735.66,1,1,3,5
15046.0,8,206,5213.7699999999995,4,4,4,12
15047.0,269,22,343.62,1,2,2,5
15048.0,64,97,384.05,2,3,2,7
15049.0,273,3,121.17000000000002,1,1,1,3
15050.0,24,78,1782.09,3,3,4,10
15051.0,22,143,1391.61,3,4,3,10
15052.0,318,30,215.78,1,2,1,4
15053.0,4,71,697.79,4,3,3,10
15054.0,11,114,302.1,4,4,1,9
15057.0,274,25,1489.5,1,2,3,6
15058.0,24,276,2124.9900000000002,3,4,4,11
15059.0,40,237,1337.72,3,4,3,10
15060.0,7,121,303.09,4,4,1,9
15061.0,3,403,54534.14,4,4,4,12
15062.0,70,57,987.86,2,3,3,8
15063.0,212,5,370.79999999999995,1,1,2,4
15065.0,37,155,3158.13,3,4,4,11
15066.0,52,42,893.59,2,3,3,8
15067.0,77,82,1744.76,2,3,4,9
15068.0,45,104,553.36,3,4,2,9
15069.0,178,70,1109.53,1,3,3,7
15070.0,372,1,106.2,1,1,1,3
15071.0,93,26,982.07,2,2,3,7
15073.0,9,54,1043.41,4,3,3,10
15074.0,104,42,748.87,2,3,3,8
15075.0,77,27,773.03,2,2,3,7
15076.0,172,49,880.85,1,3,3,7
15078.0,6,440,9743.11,4,4,4,12
15079.0,212,47,895.61,1,3,3,7
15081.0,21,33,504.8,3,2,2,7
15083.0,256,5,88.2,1,1,1,3
15087.0,281,15,306.94,1,1,1,3
15088.0,20,57,1160.07,3,3,3,9
15089.0,9,145,2420.84,4,4,4,12
15090.0,307,23,381.32,1,2,2,5
15091.0,67,30,480.71,2,2,2,6
15092.0,214,26,457.81,1,2,2,5
15093.0,17,108,4597.02,4,4,4,12
15095.0,103,47,1370.6,2,3,3,8
15096.0,42,11,219.39000000000001,3,1,1,5
15097.0,3,25,248.08,4,2,1,7
15098.0,181,3,39916.5,1,1,4,6
15099.0,83,23,410.48,2,2,2,6
15100.0,333,3,876.0,1,1,3,5
15101.0,8,8,317.53,4,1,2,7
15103.0,30,35,703.36,3,2,3,8
15104.0,196,69,1027.44,1,3,3,7
15105.0,17,101,2298.93,4,4,4,12
15106.0,17,100,1422.52,4,3,3,10
15107.0,310,17,319.5,1,1,2,4
15108.0,141,60,1300.25,2,3,3,8
15109.0,245,28,484.95,1,2,2,5
15110.0,23,35,996.1,3,2,3,8
15111.0,28,84,1567.48,3,3,3,9
15113.0,9,100,3609.33,4,3,4,11
15114.0,29,197,2760.56,3,4,4,11
15115.0,17,21,340.11,4,2,2,8
15116.0,17,45,1352.75,4,3,3,10
15117.0,14,79,1551.78,4,3,3,10
15118.0,133,1,244.8,2,1,1,4
15119.0,245,14,266.4,1,1,1,3
15120.0,133,21,358.82,2,2,2,6
15121.0,49,28,457.72,3,2,2,7
15122.0,113,82,1633.78,2,3,3,8
15123.0,6,106,2199.31,4,4,4,12
15124.0,22,15,184.19,3,1,1,5
15125.0,24,127,11528.48,3,4,4,11
15127.0,65,16,406.53,2,1,2,5
15128.0,59,102,1471.0,2,4,3,9
15129.0,49,84,3447.4,3,3,4,10
15130.0,169,22,330.11,1,2,2,5
15132.0,17,52,977.9300000000001,4,3,3,10
15133.0,127,29,982.42,2,2,3,7
15134.0,14,73,1387.99,4,3,3,10
15135.0,238,9,139.05,1,1,1,3
15136.0,2,68,1286.7,4,3,3,10
15139.0,239,13,178.96,1,1,1,3
15140.0,51,80,2354.25,2,3,4,9
15142.0,45,26,498.74,3,2,2,7
15143.0,225,14,259.45,1,1,1,3
15144.0,7,217,6580.44,4,4,4,12
15145.0,3,67,1194.73,4,3,3,10
15146.0,164,91,1327.16,1,3,3,7
15147.0,239,28,623.5,1,2,2,5
15148.0,10,20,301.29,4,2,1,7
15149.0,133,23,520.8000000000001,2,2,2,6
15150.0,16,343,5314.47,4,4,4,12
15152.0,9,271,4745.69,4,4,4,12
15153.0,30,22,329.25,3,2,2,7
15154.0,74,85,296.42,2,3,1,6
15156.0,0,55,961.49,4,3,3,10
15157.0,3,125,1936.07,4,4,4,12
15158.0,44,7,401.40000000000003,3,1,2,6
15159.0,1,710,18641.010000000002,4,4,4,12
15160.0,356,4,158.16,1,1,1,3
15163.0,17,29,304.47,4,2,1,7
15164.0,68,103,843.05,2,4,3,9
15165.0,372,27,487.75,1,2,2,5
15167.0,320,41,163.0,1,2,1,4
15168.0,25,5,106.56,3,1,1,5
15171.0,330,5,1289.5,1,1,3,5
15172.0,8,110,1624.05,4,4,3,11
15174.0,322,11,135.75,1,1,1,3
15175.0,71,23,224.14,2,2,1,5
15178.0,259,3,40.5,1,1,1,3
15179.0,17,93,2206.95,4,3,4,11
15180.0,366,6,87.5,1,1,1,3
15181.0,65,16,689.4799999999999,2,1,3,6
15182.0,153,29,622.85,1,2,2,5
15184.0,28,63,406.76,3,3,2,8
15185.0,69,21,310.62,2,2,2,6
15186.0,13,19,411.41,4,2,2,8
15187.0,1,91,4777.18,4,3,4,11
15189.0,0,212,16225.39,4,4,4,12
15192.0,119,51,1044.32,2,3,3,8
15193.0,60,19,499.32,2,2,2,6
15194.0,2,310,7616.53,4,4,4,12
15195.0,2,1,3861.0,4,1,4,9
15197.0,10,32,1079.6100000000001,4,2,3,9
15198.0,91,10,193.64,2,1,1,4
15199.0,58,13,1268.7,2,1,3,6
15201.0,86,69,1236.54,2,3,3,8
15203.0,25,142,1827.8,3,4,4,11
15204.0,356,9,316.58,1,1,2,4
15205.0,84,37,653.24,2,2,2,6
15206.0,9,9,420.29999999999995,4,1,2,7
15208.0,0,42,870.12,4,3,3,10
15210.0,224,20,331.18,1,2,2,5
15211.0,59,52,894.4100000000001,2,3,3,8
15212.0,240,5,101.8,1,1,1,3
15213.0,318,24,328.35,1,2,2,5
15214.0,1,110,1661.44,4,4,3,11
15215.0,46,35,734.94,3,2,3,8
15216.0,87,2,96.6,2,1,1,4
15218.0,10,166,5756.89,4,4,4,12
15219.0,175,9,305.75,1,1,1,3
15220.0,51,117,1778.96,2,4,4,10
15221.0,365,5,403.25,1,1,2,4
15222.0,318,5,585.0,1,1,2,4
15223.0,225,20,755.75,1,2,3,6
15224.0,357,14,322.08,1,1,2,4
15225.0,233,23,409.40000000000003,1,2,2,5
15226.0,310,8,154.41,1,1,1,3
15227.0,36,58,1219.4,3,3,3,9
15228.0,65,125,3386.71,2,4,4,10
15230.0,238,23,429.6,1,2,2,5
15232.0,112,31,612.06,2,2,2,6
15234.0,276,14,197.0,1,1,1,3
15235.0,217,143,2247.51,1,4,4,9
15236.0,298,15,321.05,1,1,2,4
15237.0,1,99,1412.32,4,3,3,10
15238.0,28,50,1071.99,3,3,3,9
15239.0,9,49,780.59,4,3,3,10
15240.0,44,78,1706.57,3,3,4,10
15241.0,66,110,1756.44,2,4,4,10
15243.0,73,22,316.68,2,2,2,6
15244.0,64,34,631.57,2,2,2,6
15245.0,133,89,2515.84,2,3,4,9
15246.0,237,33,514.15,1,2,2,5
15247.0,121,6,356.0,2,1,2,5
15249.0,31,350,6688.46,3,4,4,11
15251.0,8,111,10484.99,4,4,4,12
15252.0,35,44,740.78,3,3,3,9
15253.0,15,53,918.1999999999999,4,3,3,10
15254.0,126,18,300.36,2,2,1,5
15255.0,66,47,890.85,2,3,3,8
15256.0,148,6,98.45,1,1,1,3
15257.0,282,7,317.15,1,1,2,4
15258.0,168,34,623.16,1,2,2,5
15260.0,99,77,1810.77,2,3,4,9
15261.0,134,19,254.82,2,2,1,5
15262.0,323,10,178.95000000000002,1,1,1,3
15263.0,106,12,156.51,2,1,1,4
15264.0,63,23,393.74,2,2,2,6
15265.0,150,82,1506.1200000000001,1,3,3,7
15266.0,337,6,119.3,1,1,1,3
15267.0,21,11,1717.36,3,1,4,8
15269.0,23,2,408.8,3,1,2,6
15270.0,15,41,2379.49,4,2,4,10
15271.0,6,274,2507.07,4,4,4,12
15272.0,56,63,721.94,2,3,3,8
15274.0,3,47,716.57,4,3,3,10
15275.0,37,41,615.14,3,2,2,7
15276.0,65,52,135.31,2,3,1,6
15277.0,46,12,255.89999999999998,3,1,1,5
15279.0,354,19,290.51,1,2,1,4
15280.0,171,16,113.12,1,1,1,3
15281.0,58,139,2332.15,2,4,4,10
15286.0,49,3,240.55,3,1,1,5
15287.0,21,20,486.69,3,2,2,7
15288.0,42,88,2306.52,3,3,4,10
15289.0,28,58,939.78,3,3,3,9
15290.0,4,204,7943.22,4,4,4,12
15291.0,25,103,4668.3,3,4,4,11
15292.0,200,25,180.94,1,2,1,4
15296.0,50,194,3672.86,3,4,4,11
15297.0,9,39,641.94,4,2,2,8
15298.0,1,192,4799.9,4,4,4,12
15299.0,66,7,4507.01,2,1,4,7
15300.0,63,28,496.44,2,2,2,6
15301.0,50,243,5070.35,3,4,4,11
15303.0,289,31,574.02,1,2,2,5
15304.0,60,23,694.4000000000001,2,2,3,7
15306.0,63,58,1174.35,2,3,3,8
15307.0,95,12,205.3,2,1,1,4
15308.0,273,19,310.47,1,2,2,5
15311.0,0,2379,60767.9,4,4,4,12
15312.0,74,47,924.85,2,3,3,8
15313.0,109,1,52.0,2,1,1,4
15314.0,198,24,327.97,1,2,2,5
15315.0,63,37,570.5,2,2,2,6
15316.0,326,1,165.0,1,1,1,3
15318.0,3,33,312.62,4,2,2,8
15319.0,283,16,204.5,1,1,1,3
15320.0,43,36,267.13,3,2,1,6
15321.0,70,95,2748.31,2,3,4,9
15322.0,85,42,679.68,2,3,3,8
15325.0,103,49,162.29,2,3,1,6
15326.0,333,29,311.71,1,2,2,5
15327.0,52,10,208.75,2,1,1,4
15329.0,38,57,1049.7,3,3,3,9
15330.0,31,13,714.96,3,1,3,7
15332.0,365,35,1661.06,1,2,3,6
15333.0,207,16,1028.56,1,1,3,5
15334.0,156,99,351.67,1,3,2,6
15335.0,53,36,173.97,2,2,1,5
15339.0,65,86,574.07,2,3,2,7
15341.0,80,17,2020.52,2,1,4,7
15342.0,129,24,406.09,2,2,2,6
15343.0,86,21,364.5,2,2,2,6
15344.0,0,26,563.94,4,2,2,8
15345.0,45,20,393.54,3,2,2,7
15346.0,332,17,252.42000000000002,1,1,1,3
15347.0,365,5,201.60000000000002,1,1,1,3
15348.0,71,9,158.04,2,1,1,4
15349.0,157,72,473.81,1,3,2,6
15350.0,372,5,115.65,1,1,1,3
15351.0,11,225,1960.1100000000001,4,4,4,12
15353.0,254,63,777.02,1,3,3,7
15355.0,28,14,277.05,3,1,1,5
15356.0,30,519,2766.5,3,4,4,11
15358.0,4,551,8347.2,4,4,4,12
15360.0,39,13,427.93,3,1,2,6
15361.0,361,7,418.92,1,1,2,4
15363.0,372,16,326.0,1,1,2,4
15364.0,95,29,913.19,2,2,3,7
15365.0,25,114,2314.32,3,4,4,11
15366.0,74,44,602.51,2,3,2,7
15367.0,56,95,1877.59,2,3,4,9
15368.0,20,4,446.94000000000005,3,1,2,6
15370.0,40,94,2386.05,3,3,4,10
15372.0,136,27,2007.3999999999999,2,2,4,8
15373.0,7,132,2415.91,4,4,4,12
15374.0,128,3,168.0,2,1,1,4
15376.0,39,117,1233.3600000000001,3,4,3,10
15379.0,168,194,3703.29,1,4,4,9
15380.0,8,36,1690.2600000000002,4,2,4,10
15381.0,213,8,596.85,1,1,2,4
15382.0,14,302,5955.71,4,4,4,12
15384.0,169,41,642.41,1,2,2,5
15385.0,39,12,316.88,3,1,2,6
15386.0,185,31,394.14,1,2,2,5
15388.0,269,10,140.54,1,1,1,3
15389.0,171,1,500.0,1,1,2,4
15392.0,4,84,1535.53,4,3,3,10
15393.0,15,12,231.86,4,1,1,6
15394.0,9,85,2183.54,4,3,4,11
15395.0,325,7,107.45,1,1,1,3
15396.0,112,14,288.18,2,1,1,4
15397.0,289,6,94.0,1,1,1,3
15398.0,15,73,1345.53,4,3,3,10
15399.0,0,50,815.77,4,3,3,10
15400.0,91,12,716.2,2,1,3,6
15402.0,148,42,626.77,1,3,2,6
15405.0,188,8,349.1,1,1,2,4
15406.0,30,53,510.71000000000004,3,3,2,8
15407.0,33,153,1056.44,3,4,3,10
15408.0,263,34,267.18,1,2,1,4
15410.0,83,122,3450.84,2,4,4,10
15411.0,25,99,1358.88,3,3,3,9
15412.0,170,10,190.53,1,1,1,3
15414.0,9,39,774.9000000000001,4,2,3,9
15415.0,312,48,572.8100000000001,1,3,2,6
15416.0,64,192,3984.32,2,4,4,10
15417.0,84,28,508.8,2,2,2,6
15419.0,24,8,135.86,3,1,1,5
15421.0,58,53,950.36,2,3,3,8
15422.0,322,6,97.7,1,1,1,3
15423.0,37,2,43.5,3,1,1,5
15424.0,253,17,383.34,1,1,2,4
15426.0,18,292,1447.39,3,4,3,10
15427.0,32,306,1483.14,3,4,3,10
15428.0,14,6,93.78,4,1,1,6
15429.0,26,82,397.35,3,3,2,8
15432.0,22,10,171.19,3,1,1,5
15433.0,213,41,533.3,1,2,2,5
15434.0,7,55,1041.48,4,3,3,10
15435.0,21,29,149.29,3,2,1,6
15436.0,11,329,1122.53,4,4,3,11
15437.0,261,45,200.16,1,3,1,5
15438.0,130,25,156.57999999999998,2,2,1,5
15440.0,54,62,383.68,2,3,2,7
15442.0,248,2,594.0,1,1,2,4
15443.0,1,382,3236.91,4,4,4,12
15444.0,8,219,1418.26,4,4,3,11
15445.0,263,5,113.5,1,1,1,3
15447.0,330,9,155.17,1,1,1,3
15448.0,312,28,494.64,1,2,2,5
15449.0,25,60,974.52,3,3,3,9
15450.0,29,30,429.84,3,2,2,7
15452.0,29,58,538.73,3,3,2,8
15453.0,1,286,1388.37,4,4,3,11
15454.0,361,25,179.1,1,2,1,4
15456.0,282,60,447.22,1,3,2,6
15457.0,261,58,237.07,1,3,1,5
15458.0,24,7,161.64,3,1,1,5
15460.0,353,58,216.76,1,3,1,5
15462.0,93,11,234.6,2,1,1,4
15463.0,28,7,126.14,3,1,1,5
15464.0,337,157,1048.85,1,4,3,8
15465.0,19,97,7354.62,3,3,4,10
15466.0,84,57,334.53,2,3,2,7
15467.0,8,52,524.88,4,3,2,9
15468.0,50,24,467.51,3,2,2,7
15469.0,49,24,538.55,3,2,2,7
15471.0,1,77,469.48,4,3,2,9
15472.0,112,76,371.56,2,3,2,7
15473.0,13,11,1771.2,4,1,4,9
15475.0,76,29,454.10999999999996,2,2,2,6
15478.0,39,46,1441.42,3,3,3,9
15480.0,115,45,905.5,2,3,3,8
15482.0,15,98,11054.96,4,3,4,11
15483.0,160,88,233.81,1,3,1,5
15484.0,0,188,3594.31,4,4,4,12
15485.0,29,86,2575.0,3,3,4,10
15488.0,92,2,91.32000000000001,2,1,1,4
15489.0,22,50,1134.28,3,3,3,9
15491.0,94,154,3100.09,2,4,4,10
15492.0,27,35,659.4599999999999,3,2,2,7
15493.0,32,297,2001.8,3,4,4,11
15494.0,20,125,1299.23,3,4,3,10
15497.0,17,15,1262.2,4,1,3,8
15498.0,2,512,13316.4,4,4,4,12
15500.0,7,68,1131.56,4,3,3,10
15502.0,15,213,10384.93,4,4,4,12
15503.0,362,70,147.09,1,3,1,5
15504.0,80,13,52.83,2,1,1,4
15505.0,52,97,3610.96,2,3,4,9
15506.0,22,164,979.26,3,4,3,10
15507.0,171,46,492.36,1,3,2,6
15508.0,188,92,1000.27,1,3,3,7
15510.0,330,1,250.0,1,1,1,3
15511.0,11,160,909.23,4,4,3,11
15512.0,155,7,121.0,1,1,1,3
15513.0,32,308,14758.220000000001,3,4,4,11
15514.0,11,178,4139.46,4,4,4,12
15516.0,44,15,62.43,3,1,1,5
15517.0,232,27,267.03,1,2,1,4
15518.0,63,214,1942.45,2,4,4,10
15520.0,1,18,343.5,4,2,2,8
15521.0,39,185,3000.2,3,4,4,11
15522.0,32,57,398.84,3,3,2,8
15523.0,83,10,412.01000000000005,2,1,2,5
15524.0,24,1,440.0,3,1,2,6
15525.0,1,178,825.92,4,4,3,11
15526.0,32,4,148.44,3,1,1,5
15527.0,18,163,2429.78,3,4,4,11
15528.0,253,26,229.33,1,2,1,4
15529.0,22,672,3995.23,3,4,4,11
15530.0,21,108,1502.35,3,4,3,10
15531.0,7,228,2007.44,4,4,4,12
15532.0,24,256,1580.93,3,4,3,10
15533.0,18,83,807.57,3,3,3,9
15535.0,172,75,536.4,1,3,2,6
15537.0,162,24,110.92,1,2,1,4
15539.0,6,41,538.46,4,2,2,8
15540.0,10,15,213.3,4,1,1,6
15541.0,113,29,85.13000000000001,2,2,1,5
15543.0,287,28,127.86,1,2,1,4
15544.0,8,259,3546.71,4,4,4,12
15545.0,53,81,292.71999999999997,2,3,1,6
15547.0,6,702,4954.84,4,4,4,12
15549.0,76,115,1693.26,2,4,4,10
15550.0,3,61,575.63,4,3,2,9
15551.0,36,29,436.06,3,2,2,7
15552.0,216,17,90.12,1,1,1,3
15553.0,59,56,437.23,2,3,2,7
15554.0,277,14,217.2,1,1,1,3
15555.0,11,899,4805.17,4,4,4,12
15556.0,23,31,279.77,3,2,1,6
15557.0,28,20,473.65000000000003,3,2,2,7
15561.0,11,27,800.59,4,2,3,9
15562.0,351,1,134.55,1,1,1,3
15563.0,21,113,1400.44,3,4,3,10
15565.0,49,8,173.16,3,1,1,5
15567.0,18,7,186.01,3,1,1,5
15568.0,2,53,758.29,4,3,3,10
15569.0,103,31,1375.71,2,2,3,7
15570.0,6,323,4165.52,4,4,4,12
15571.0,11,57,650.4300000000001,4,3,2,9
15572.0,4,215,2552.86,4,4,4,12
15573.0,31,104,607.45,3,4,2,9
15574.0,177,168,702.25,1,4,3,8
15576.0,37,45,940.6700000000001,3,3,3,9
15577.0,150,39,258.88,1,2,1,4
15578.0,161,13,127.1,1,1,1,3
15579.0,68,51,348.6,2,3,2,7
15581.0,120,150,3679.9700000000003,2,4,4,10
15582.0,24,44,682.9100000000001,3,3,3,9
15584.0,23,123,725.11,3,4,3,10
15585.0,176,31,455.3,1,2,2,5
15587.0,49,9,913.6800000000001,3,1,3,7
15589.0,255,29,478.53000000000003,1,2,2,5
15592.0,46,24,388.58,3,2,2,7
15593.0,70,5,199.8,2,1,1,4
15594.0,15,103,1771.78,4,4,4,12
15596.0,100,77,1406.59,2,3,3,8
15597.0,34,22,324.57,3,2,2,7
15598.0,52,14,240.68,2,1,1,4
15599.0,26,52,761.74,3,3,3,9
15601.0,10,410,6776.56,4,4,4,12
15602.0,7,47,1297.8700000000001,4,3,3,10
15603.0,78,2,48.480000000000004,2,1,1,4
15604.0,51,17,216.39,2,1,1,4
15605.0,35,67,1198.23,3,3,3,9
15606.0,60,77,2920.16,2,3,4,9
15607.0,336,13,104.76,1,1,1,3
15608.0,27,60,1093.68,3,3,3,9
15609.0,183,16,298.48,1,1,1,3
15610.0,51,6,112.46000000000001,2,1,1,4
15611.0,9,43,1591.45,4,3,3,10
15612.0,35,6,195.15,3,1,1,5
15615.0,9,423,10399.74,4,4,4,12
15618.0,32,45,776.851,3,3,3,9
15619.0,10,3,336.40000000000003,4,1,2,7
15620.0,56,100,1553.18,2,3,3,8
15621.0,3,16,1293.03,4,1,3,8
15622.0,42,185,3709.56,3,4,4,11
15623.0,140,19,301.03,2,2,1,5
15624.0,116,34,588.13,2,2,2,6
15625.0,103,64,1534.26,2,3,3,8
15626.0,74,49,675.8,2,3,3,8
15628.0,4,155,2870.2400000000002,4,4,4,12
15630.0,44,60,1186.35,3,3,3,9
15632.0,15,167,3285.31,4,4,4,12
15634.0,16,15,243.55,4,1,1,6
15636.0,89,25,724.76,2,2,3,7
15637.0,52,15,223.36,2,1,1,4
15639.0,133,25,425.32,2,2,2,6
15640.0,3,484,12515.66,4,4,4,12
15641.0,104,119,1887.2,2,4,4,10
15643.0,191,33,664.0,1,2,2,5
15644.0,165,238,813.0,1,4,3,8
15645.0,18,52,612.01,3,3,2,8
15646.0,157,35,447.64000000000004,1,2,2,5
15648.0,203,25,657.35,1,2,2,5
15649.0,335,2,816.0,1,1,3,5
15651.0,36,32,646.3,3,2,2,7
15652.0,90,21,337.74,2,2,2,6
15653.0,92,6,877.4399999999999,2,1,3,6
15654.0,8,21,922.53,4,2,3,9
15655.0,242,34,560.67,1,2,2,5
15656.0,44,47,748.5,3,3,3,9
15657.0,22,1,30.0,3,1,1,5
15658.0,189,48,1024.1000000000001,1,3,3,7
15659.0,43,11,306.45,3,1,1,5
15660.0,24,90,1600.86,3,3,3,9
15661.0,316,5,309.8,1,1,2,4
15663.0,105,9,138.14,2,1,1,4
15664.0,50,17,386.43,3,1,2,6
15665.0,167,116,2242.01,1,4,4,9
15667.0,39,13,301.32,3,1,1,5
15668.0,217,1,76.32000000000001,1,1,1,3
15669.0,39,33,684.34,3,2,3,8
15670.0,296,12,173.05,1,1,1,3
15671.0,18,78,2657.13,3,3,4,10
15673.0,87,155,2881.02,2,4,4,10
15674.0,72,114,2446.6,2,4,4,10
15675.0,80,21,323.69,2,2,2,6
15676.0,18,202,3435.76,3,4,4,11
15677.0,48,33,657.23,3,2,2,7
15678.0,52,12,352.7,2,1,2,5
15679.0,23,110,781.28,3,4,3,10
15680.0,8,78,1333.68,4,3,3,10
15681.0,24,53,1426.16,3,3,3,9
15683.0,116,10,193.75,2,1,1,4
15687.0,8,166,2993.1,4,4,4,12
15689.0,119,9,254.1,2,1,1,4
15690.0,3,19,239.76,4,2,1,7
15691.0,251,2,136.8,1,1,1,3
15692.0,27,12,191.04,3,1,1,5
15694.0,0,78,6479.4,4,3,4,11
15695.0,266,22,409.98,1,2,2,5
15696.0,32,171,2736.46,3,4,4,11
15699.0,17,18,309.65,4,2,2,8
15700.0,171,86,696.68,1,3,3,7
15701.0,1,237,1542.14,4,4,3,11
15703.0,264,5,211.5,1,1,1,3
15704.0,139,117,2293.62,2,4,4,10
15705.0,200,6,143.1,1,1,1,3
15706.0,63,55,1060.56,2,3,3,8
15707.0,34,214,945.58,3,4,3,10
15708.0,40,288,3364.2400000000002,3,4,4,11
15709.0,283,6,133.25,1,1,1,3
15712.0,8,53,1072.3600000000001,4,3,3,10
15713.0,142,19,356.7,1,2,2,5
15714.0,11,35,330.88,4,2,2,8
15716.0,145,118,1118.81,1,4,3,8
15717.0,233,7,150.3,1,1,1,3
15719.0,32,937,5045.61,3,4,4,11
15720.0,23,128,598.73,3,4,2,9
15721.0,11,91,507.08,4,3,2,9
15722.0,35,69,2222.56,3,3,4,10
15723.0,364,41,203.1,1,2,1,4
15724.0,200,11,218.25,1,1,1,3
15725.0,14,32,415.25,4,2,2,8
15727.0,16,302,5178.96,4,4,4,12
15729.0,212,5,85.0,1,1,1,3
15730.0,65,70,1120.88,2,3,3,8
15732.0,211,14,294.12,1,1,1,3
15733.0,282,10,162.3,1,1,1,3
15734.0,114,26,1339.45,2,2,3,7
15737.0,14,72,1205.1200000000001,4,3,3,10
15738.0,18,173,4812.42,3,4,4,11
15739.0,65,8,449.12,2,1,2,5
15740.0,48,9,154.88,3,1,1,5
15743.0,15,88,784.46,4,3,3,10
15744.0,77,3,34.8,2,1,1,4
15745.0,18,62,1094.59,3,3,3,9
15746.0,133,28,196.88,2,2,1,5
15747.0,12,93,974.04,4,3,3,10
15748.0,39,21,149.31,3,2,1,6
15749.0,234,10,44534.3,1,1,4,6
15750.0,2,293,2465.48,4,4,4,12
15752.0,39,411,2637.38,3,4,4,11
15753.0,304,1,79.2,1,1,1,3
15754.0,50,28,458.57,3,2,2,7
15755.0,9,141,2364.25,4,4,4,12
15756.0,60,192,532.96,2,4,2,8
15757.0,65,45,714.42,2,3,3,8
15758.0,24,9,205.25,3,1,1,5
15759.0,217,7,253.04,1,1,1,3
15762.0,64,37,583.75,2,2,2,6
15763.0,31,61,1086.92,3,3,3,9
15764.0,87,180,3279.97,2,4,4,10
15766.0,63,11,315.06,2,1,2,5
15768.0,115,27,621.8299999999999,2,2,2,6
15769.0,6,130,56252.72,4,4,4,12
15773.0,5,10,635.6800000000001,4,1,2,7
15774.0,68,25,270.8,2,2,1,5
15775.0,244,7,104.9,1,1,1,3
15776.0,132,18,241.62,2,2,1,5
15777.0,240,21,1047.11,1,2,3,6
15780.0,183,29,475.28000000000003,1,2,2,5
15781.0,24,20,345.46,3,2,2,7
15782.0,9,43,2614.7400000000002,4,3,4,11
15783.0,10,14,246.3,4,1,1,6
15785.0,32,83,2328.9700000000003,3,3,4,10
15786.0,45,267,4932.2,3,4,4,11
15787.0,25,206,948.05,3,4,3,10
15789.0,357,25,351.3,1,2,2,5
15790.0,9,35,220.85,4,2,1,7
15791.0,43,75,1612.69,3,3,3,9
15793.0,14,12,965.61,4,1,3,8
15795.0,149,42,610.01,1,3,2,6
15796.0,0,133,2711.56,4,4,4,12
15797.0,112,8,2207.4,2,1,4,7
15799.0,75,98,884.14,2,3,3,8
15800.0,106,119,699.08,2,4,3,9
15801.0,45,64,1063.95,3,3,3,9
15802.0,142,1,451.42,1,1,2,4
15803.0,50,8,415.82000000000005,3,1,2,6
15804.0,0,263,4206.39,4,4,4,12
15805.0,22,301,5528.4800000000005,3,4,4,11
15806.0,45,31,784.58,3,2,3,8
15807.0,49,48,903.9,3,3,3,9
15808.0,305,208,3734.9700000000003,1,4,4,9
15809.0,35,35,515.77,3,2,2,7
15810.0,78,89,1391.98,2,3,3,8
15811.0,21,133,2218.62,3,4,4,11
15812.0,106,41,1801.14,2,2,4,8
15813.0,207,40,1303.9099999999999,1,2,3,6
15814.0,16,72,1945.33,4,3,4,11
15815.0,63,49,2100.6,2,3,4,9
15819.0,48,123,1905.45,3,4,4,11
15820.0,319,17,206.98,1,1,1,3
15821.0,43,62,570.96,3,3,2,8
15822.0,2,33,885.47,4,2,3,9
15823.0,371,1,15.0,1,1,1,3
15825.0,171,20,532.94,1,2,2,5
15826.0,55,68,1654.31,2,3,3,8
15827.0,72,115,1836.0900000000001,2,4,4,10
15829.0,98,51,636.14,2,3,2,7
15830.0,37,39,576.0,3,2,2,7
15831.0,57,68,801.76,2,3,3,8
15832.0,253,54,836.79,1,3,3,7
15834.0,69,273,2233.75,2,4,4,10
15835.0,43,50,954.09,3,3,3,9
15836.0,49,10,137.37,3,1,1,5
15837.0,64,24,391.98,2,2,2,6
15838.0,10,167,33643.08,4,4,4,12
15839.0,32,62,1048.49,3,3,3,9
15840.0,58,27,355.56,2,2,2,6
15841.0,72,47,1224.06,2,3,3,8
15843.0,303,8,118.95000000000002,1,1,1,3
15844.0,45,11,130.73999999999998,3,1,1,5
15845.0,17,138,3711.77,4,4,4,12
15847.0,37,22,389.27,3,2,2,7
15850.0,18,97,238.85,3,3,1,7
15852.0,186,22,160.71,1,2,1,4
15853.0,51,30,110.8,2,2,1,5
15854.0,3,140,2974.65,4,4,4,12
15855.0,136,80,712.24,2,3,3,8
15856.0,3,645,16387.57,4,4,4,12
15857.0,18,14,297.0,3,1,1,5
15858.0,15,191,1438.85,4,4,3,11
15860.0,40,142,977.21,3,4,3,10
15861.0,11,546,3165.36,4,4,4,12
15862.0,7,147,832.88,4,4,3,11
15863.0,25,18,68.84,3,2,1,6
15864.0,21,20,1936.3200000000002,3,2,4,9
15865.0,40,40,895.13,3,2,3,8
15866.0,100,45,230.53,2,3,1,6
15867.0,4,461,3812.64,4,4,4,12
15869.0,276,15,149.64,1,1,1,3
15870.0,32,76,354.09000000000003,3,3,2,8
15872.0,14,128,360.93,4,4,2,10
15874.0,63,120,4405.88,2,4,4,10
15877.0,1,129,493.28,4,4,2,10
15880.0,368,105,343.28000000000003,1,4,2,7
15881.0,311,29,501.39000000000004,1,2,2,5
15882.0,198,23,516.36,1,2,2,5
15883.0,1,49,396.48,4,3,2,9
15885.0,92,18,379.35,2,2,2,6
15886.0,59,12,181.09,2,1,1,4
15888.0,80,12,168.31,2,1,1,4
15889.0,156,93,446.87,1,3,2,6
15891.0,226,62,524.52,1,3,2,6
15894.0,252,41,263.55,1,2,1,4
15895.0,149,11,179.17,1,1,1,3
15897.0,193,24,222.05,1,2,1,4
15898.0,0,86,1388.88,4,3,3,10
15899.0,368,4,56.25,1,1,1,3
15900.0,23,51,351.11,3,3,2,8
15901.0,16,116,363.88,4,4,2,10
15903.0,9,74,5126.76,4,3,4,11
15904.0,7,30,164.68,4,2,1,7
15906.0,19,150,1567.69,3,4,3,10
15907.0,3,249,967.45,4,4,3,11
15909.0,173,7,191.94,1,1,1,3
15910.0,0,267,1232.18,4,4,3,11
15912.0,177,19,264.62,1,2,1,4
15916.0,15,155,1528.09,4,4,3,11
15917.0,247,12,123.1,1,1,1,3
15918.0,190,40,334.23,1,2,2,5
15919.0,19,143,639.89,3,4,2,9
15920.0,153,60,167.5,1,3,1,5
15921.0,172,25,336.03000000000003,1,2,2,5
15922.0,372,11,369.5,1,1,2,4
15923.0,372,21,127.08,1,2,1,4
15925.0,193,12,207.15,1,1,1,3
15930.0,66,21,426.63,2,2,2,6
15932.0,3,115,2495.87,4,4,4,12
15933.0,20,74,1107.46,3,3,3,9
15935.0,238,12,416.86,1,1,2,4
15937.0,63,7,145.35,2,1,1,4
15938.0,111,18,404.58,2,2,2,6
15939.0,89,76,6115.01,2,3,4,9
15940.0,310,1,35.8,1,1,1,3
15942.0,133,14,337.44,2,1,2,5
15944.0,276,6,325.1,1,1,2,4
15945.0,364,2,181.0,1,1,1,3
15947.0,82,29,1708.24,2,2,4,8
15948.0,7,60,955.24,4,3,3,10
15949.0,16,19,364.72,4,2,2,8
15950.0,31,98,1765.51,3,3,4,10
15951.0,8,41,708.22,4,2,3,9
15952.0,33,91,806.57,3,3,3,9
15953.0,14,98,1659.3799999999999,4,3,3,10
15955.0,23,183,4416.26,3,4,4,11
15957.0,31,42,428.89,3,3,2,8
15958.0,73,7,104.35,2,1,1,4
15963.0,19,28,470.76,3,2,2,7
15965.0,16,122,845.64,4,4,3,11
15967.0,22,84,418.83,3,3,2,8
15969.0,2,20,666.1,4,2,2,8
15970.0,303,11,314.1,1,1,2,4
15971.0,17,35,4199.85,4,2,4,10
15973.0,366,4,307.82000000000005,1,1,2,4
15974.0,38,176,3442.15,3,4,4,11
15975.0,83,24,371.01,2,2,2,6
15976.0,164,98,430.94,1,3,2,6
15977.0,16,65,1054.73,4,3,3,10
15978.0,76,49,1098.78,2,3,3,8
15980.0,88,43,2398.86,2,3,4,9
15981.0,24,97,3408.48,3,3,4,10
15983.0,21,113,1475.02,3,4,3,10
15984.0,2,270,2837.67,4,4,4,12
15985.0,122,37,1142.42,2,2,3,7
15986.0,29,14,168.12,3,1,1,5
15987.0,11,140,1451.28,4,4,3,11
15988.0,18,27,158.03,3,2,1,6
15990.0,43,52,792.11,3,3,3,9
15992.0,3,3,41.989999999999995,4,1,1,6
15993.0,8,552,2797.57,4,4,4,12
15994.0,54,35,427.07,2,2,2,6
15996.0,87,130,1060.68,2,4,3,9
15998.0,36,506,3089.97,3,4,4,11
16000.0,2,9,12393.7,4,1,4,9
16003.0,29,103,2735.37,3,4,4,11
16005.0,11,218,615.39,4,4,2,10
16006.0,210,8,101.4,1,1,1,3
16007.0,47,385,1701.94,3,4,4,11
16008.0,23,33,478.78,3,2,2,7
16009.0,21,90,992.71,3,3,3,9
16010.0,245,86,407.5,1,3,2,6
16011.0,7,212,3362.71,4,4,4,12
16012.0,34,94,1415.29,3,3,3,9
16013.0,3,139,37130.6,4,4,4,12
16014.0,37,145,662.38,3,4,2,9
16015.0,3,182,705.39,4,4,3,11
16016.0,2,235,1508.76,4,4,3,11
16017.0,46,32,211.88,3,2,1,6
16018.0,38,28,408.90000000000003,3,2,2,7
16019.0,46,160,3786.2400000000002,3,4,4,11
16020.0,16,46,851.01,4,3,3,10
16022.0,259,76,628.28,1,3,2,6
16023.0,45,101,719.81,3,4,3,10
16024.0,11,64,251.24,4,3,1,8
16025.0,29,28,439.65999999999997,3,2,2,7
16026.0,42,32,236.09,3,2,1,6
16027.0,91,16,934.62,2,1,3,6
16029.0,38,242,81024.84,3,4,4,11
16030.0,309,29,331.24,1,2,2,5
16031.0,91,100,548.94,2,3,2,7
16033.0,5,1137,8816.4,4,4,4,12
16034.0,195,22,437.7,1,2,2,5
16036.0,86,55,758.92,2,3,3,8
16037.0,269,39,855.02,1,2,3,6
16038.0,7,26,471.78000000000003,4,2,2,8
16040.0,64,65,1313.55,2,3,3,8
16041.0,30,6,3166.4,3,1,4,8
16042.0,21,71,1197.27,3,3,3,9
16043.0,37,39,773.99,3,2,3,8
16045.0,119,83,1340.7,2,3,3,8
16048.0,372,8,256.44,1,1,1,3
16049.0,39,312,1111.79,3,4,3,10
16050.0,173,10,137.9,1,1,1,3
16052.0,53,34,362.06,2,2,2,6
16053.0,32,84,1511.95,3,3,3,9
16054.0,144,70,783.9,1,3,3,7
16055.0,220,8,134.8,1,1,1,3
16056.0,44,68,664.85,3,3,2,8
16057.0,15,121,2263.12,4,4,4,12
16059.0,65,180,1459.8600000000001,2,4,3,9
16062.0,9,64,1153.62,4,3,3,10
16063.0,259,23,335.32,1,2,2,5
16065.0,364,74,372.09,1,3,2,6
16066.0,16,102,1521.87,4,4,3,11
16070.0,21,33,852.15,3,2,3,8
16071.0,44,21,326.24,3,2,2,7
16072.0,287,23,584.3199999999999,1,2,2,5
16073.0,296,1,122.39999999999999,1,1,1,3
16076.0,2,129,2234.73,4,4,4,12
16078.0,283,1,79.2,1,1,1,3
16079.0,16,21,1352.0,4,2,3,9
16080.0,81,10,217.16,2,1,1,4
16081.0,55,227,2806.9,2,4,4,10
16083.0,100,31,1317.62,2,2,3,7
16084.0,298,38,436.18,1,2,2,5
16085.0,22,167,981.51,3,4,3,10
16086.0,58,39,1121.39,2,2,3,7
16091.0,154,18,315.06,1,2,2,5
16092.0,114,51,817.86,2,3,3,8
16093.0,106,1,17.0,2,1,1,4
16094.0,11,63,1078.23,4,3,3,10
16096.0,263,12,320.62,1,1,2,4
16097.0,239,10,185.04999999999998,1,1,1,3
16098.0,87,67,2005.63,2,3,4,9
16099.0,49,39,731.9,3,2,3,8
16101.0,70,76,1290.7,2,3,3,8
16102.0,41,57,1842.14,3,3,4,10
16103.0,6,48,1429.64,4,3,3,10
16104.0,61,29,302.36,2,2,1,5
16105.0,248,13,336.96,1,1,2,4
16106.0,65,6,108.38,2,1,1,4
16107.0,17,31,3204.1600000000003,4,2,4,10
16108.0,84,48,842.5,2,3,3,8
16109.0,218,18,611.88,1,2,2,5
16110.0,44,354,1337.48,3,4,3,10
16112.0,142,16,195.73999999999998,1,1,1,3
16113.0,182,30,161.38,1,2,1,4
16114.0,170,8,135.75000000000003,1,1,1,3
16115.0,9,284,1667.97,4,4,4,12
16116.0,211,34,612.78,1,2,2,5
16117.0,189,30,232.21,1,2,1,4
16119.0,7,16,423.36,4,1,2,7
16120.0,58,30,1309.14,2,2,3,7
16121.0,56,212,867.11,2,4,3,9
16122.0,72,38,684.4200000000001,2,2,3,7
16123.0,51,16,307.78,2,1,2,5
16124.0,316,11,249.0,1,1,1,3
16125.0,366,13,289.35,1,1,1,3
16126.0,28,117,6287.77,3,4,4,11
16127.0,38,40,656.25,3,2,2,7
16128.0,17,89,1880.22,4,3,4,11
16131.0,51,78,3506.54,2,3,4,9
16133.0,3,339,14589.04,4,4,4,12
16134.0,21,35,618.09,3,2,2,7
16135.0,262,21,517.55,1,2,2,5
16136.0,59,37,709.38,2,2,3,7
16139.0,18,31,635.41,3,2,2,7
16140.0,65,35,725.18,2,2,3,7
16141.0,87,30,620.4,2,2,2,6
16142.0,249,37,535.34,1,2,2,5
16143.0,2,117,2424.94,4,4,4,12
16144.0,246,1,175.2,1,1,1,3
16145.0,8,224,3799.4900000000002,4,4,4,12
16146.0,156,29,734.13,1,2,3,6
16147.0,133,22,375.0,2,2,2,6
16148.0,295,1,76.32000000000001,1,1,1,3
16149.0,4,18,280.52,4,2,1,7
16150.0,42,117,2053.02,3,4,4,11
16152.0,268,29,1829.04,1,2,4,7
16153.0,49,89,1824.23,3,3,4,10
16156.0,8,130,3122.04,4,4,4,12
16157.0,15,18,656.69,4,2,2,8
16159.0,281,14,348.2,1,1,2,4
16160.0,64,20,1025.44,2,2,3,7
16161.0,1,474,5575.56,4,4,4,12
16162.0,251,2,37.4,1,1,1,3
16163.0,231,6,856.6,1,1,3,5
16164.0,16,34,822.48,4,2,3,9
16168.0,10,98,3787.6,4,3,4,11
16169.0,7,85,1822.97,4,3,4,11
16170.0,50,125,1885.05,3,4,4,11
16171.0,58,3,73.2,2,1,1,4
16172.0,94,69,1140.21,2,3,3,8
16173.0,15,84,1418.32,4,3,3,10
16174.0,125,23,1009.5500000000001,2,2,3,7
16175.0,93,58,1037.59,2,3,3,8
16177.0,49,15,331.95,3,1,2,6
16178.0,137,8,197.9,2,1,1,4
16179.0,60,11,215.83,2,1,1,4
16180.0,99,162,10254.18,2,4,4,10
16181.0,72,11,305.54,2,1,1,4
16182.0,71,28,6617.65,2,2,4,8
16183.0,66,15,338.71000000000004,2,1,2,5
16184.0,63,45,1158.79,2,3,3,8
16185.0,16,31,529.41,4,2,2,8
16186.0,22,218,4006.94,3,4,4,11
16187.0,31,295,6911.4400000000005,3,4,4,11
16188.0,44,67,981.86,3,3,3,9
16189.0,15,11,215.48,4,1,1,6
16190.0,39,6,215.08,3,1,1,5
16191.0,2,134,5180.52,4,4,4,12
16193.0,236,19,314.45,1,2,2,5
16198.0,74,15,400.68100000000004,2,1,2,5
16200.0,3,179,1080.6200000000001,4,4,3,11
16201.0,2,111,1863.47,4,4,4,12
16202.0,360,18,365.27,1,2,2,5
16203.0,58,35,592.9,2,2,2,6
16204.0,22,57,405.71,3,3,2,8
16205.0,30,98,761.38,3,3,3,9
16206.0,54,63,537.0600000000001,2,3,2,7
16207.0,24,19,394.38,3,2,2,7
16208.0,44,66,664.26,3,3,2,8
16209.0,88,46,2262.62,2,3,4,9
16210.0,1,123,21086.3,4,4,4,12
16211.0,88,23,547.02,2,2,2,6
16212.0,18,41,690.34,3,2,3,8
16213.0,78,6,159.0,2,1,1,4
16214.0,170,44,1062.75,1,3,3,7
16215.0,80,14,242.35,2,1,1,4
16216.0,266,37,914.9300000000001,1,2,3,6
16217.0,234,15,304.25,1,1,1,3
16218.0,29,84,3084.68,3,3,4,10
16221.0,36,97,864.86,3,3,3,9
16222.0,317,137,846.72,1,4,3,8
16224.0,56,96,1295.3,2,3,3,8
16225.0,44,134,1096.32,3,4,3,10
16226.0,202,8,255.12,1,1,1,3
16227.0,224,6,314.22,1,1,2,4
16229.0,86,47,1010.6,2,3,3,8
16230.0,189,35,542.03,1,2,2,5
16232.0,43,37,990.88,3,2,3,8
16233.0,70,22,536.6800000000001,2,2,2,6
16235.0,40,46,867.31,3,3,3,9
16236.0,77,20,432.2,2,2,2,6
16239.0,56,19,414.2,2,2,2,6
16240.0,23,135,3718.8,3,4,4,11
16241.0,9,662,2607.87,4,4,4,12
16242.0,7,294,3603.21,4,4,4,12
16243.0,33,51,409.1,3,3,2,8
16244.0,211,91,1522.75,1,3,3,7
16245.0,23,90,1413.66,3,3,3,9
16247.0,169,16,114.56,1,1,1,3
16248.0,61,7,152.94,2,1,1,4
16249.0,52,69,1800.07,2,3,4,9
16250.0,260,24,389.44,1,2,2,5
16253.0,66,123,3683.86,2,4,4,10
16255.0,16,270,2619.91,4,4,4,12
16256.0,266,13,752.4300000000001,1,1,3,5
16257.0,176,2,46.95,1,1,1,3
16258.0,44,135,5203.51,3,4,4,11
16260.0,50,18,1035.45,3,2,3,8
16261.0,16,124,746.83,4,4,3,11
16265.0,8,258,5447.0,4,4,4,12
16266.0,73,61,861.89,2,3,3,8
16268.0,70,45,667.65,2,3,2,7
16270.0,352,54,1141.24,1,3,3,7
16271.0,2,133,1429.24,4,4,3,11
16272.0,116,25,411.7,2,2,2,6
16274.0,372,67,357.95,1,3,2,6
16275.0,196,33,559.87,1,2,2,5
16276.0,176,6,810.6000000000001,1,1,3,5
16278.0,99,23,566.38,2,2,2,6
16279.0,20,107,1509.58,3,4,3,10
16281.0,71,17,2062.06,2,1,4,7
16282.0,339,11,168.3,1,1,1,3
16283.0,5,166,1570.81,4,4,3,11
16284.0,30,109,823.97,3,4,3,10
16287.0,169,8,142.5,1,1,1,3
16292.0,121,17,302.25,2,1,1,4
16293.0,21,118,2248.9900000000002,3,4,4,11
16295.0,9,79,1328.55,4,3,3,10
16297.0,268,20,301.9,1,2,1,4
16298.0,22,27,598.2,3,2,2,7
16302.0,126,11,233.22,2,1,1,4
16303.0,25,162,5360.63,3,4,4,11
16305.0,138,22,361.21999999999997,2,2,2,6
16306.0,213,41,632.27,1,2,2,5
16308.0,37,4,2560.0,3,1,4,8
16309.0,105,42,706.57,2,3,3,8
16311.0,17,37,616.26,4,2,2,8
16313.0,2,16,274.15000000000003,4,1,1,6
16315.0,330,14,226.37,1,1,1,3
16316.0,63,151,2938.91,2,4,4,10
16317.0,119,69,1341.65,2,3,3,8
16318.0,34,19,328.15,3,2,2,7
16319.0,217,3,404.40000000000003,1,1,2,4
16320.0,171,56,1038.46,1,3,3,7
16321.0,71,12,373.65000000000003,2,1,2,5
16322.0,0,37,326.75,4,2,2,8
16323.0,195,1,207.50000000000003,1,1,1,3
16324.0,127,118,428.68,2,4,2,8
16325.0,46,18,594.24,3,2,2,7
16326.0,5,319,3110.96,4,4,4,12
16327.0,13,319,3844.22,4,4,4,12
16330.0,17,39,251.91,4,2,1,7
16332.0,27,153,1593.2,3,4,3,10
16333.0,7,45,26626.8,4,3,4,11
16337.0,36,10,151.05,3,1,1,5
16338.0,156,11,214.79999999999998,1,1,1,3
16339.0,283,20,109.95,1,2,1,4
16340.0,106,153,549.07,2,4,2,8
16341.0,24,77,1971.87,3,3,4,10
16342.0,74,15,322.41,2,1,2,5
16343.0,15,47,370.47999999999996,4,3,2,9
16344.0,157,2,101.10000000000001,1,1,1,3
16345.0,43,38,575.41,3,2,2,7
16347.0,10,92,887.65,4,3,3,10
16348.0,31,235,1469.45,3,4,3,10
16349.0,290,9,53.5,1,1,1,3
16350.0,20,57,1116.47,3,3,3,9
16351.0,332,8,153.9,1,1,1,3
16352.0,17,28,494.44,4,2,2,8
16353.0,3,94,6675.71,4,3,4,11
16354.0,62,39,395.8,2,2,2,6
16356.0,197,31,211.77,1,2,1,4
16357.0,32,34,658.88,3,2,2,7
16358.0,0,109,2027.5,4,4,4,12
16359.0,6,66,1750.92,4,3,4,11
16360.0,4,662,3512.53,4,4,4,12
16361.0,9,106,896.66,4,4,3,11
16362.0,31,81,734.77,3,3,3,9
16363.0,52,5,109.36000000000001,2,1,1,4
16364.0,11,53,707.04,4,3,3,10
16365.0,17,51,1540.42,4,3,3,10
16366.0,18,18,327.3,3,2,2,7
16367.0,36,130,804.49,3,4,3,10
16368.0,1,76,497.43,4,3,2,9
16369.0,17,118,1553.66,4,4,3,11
16370.0,81,228,1320.56,2,4,3,9
16372.0,32,97,367.93,3,3,2,8
16374.0,65,111,473.03000000000003,2,4,2,8
16376.0,8,125,987.01,4,4,3,11
16377.0,266,5,676.2,1,1,3,5
16378.0,246,23,362.95,1,2,2,5
16379.0,3,108,2157.4,4,4,4,12
16380.0,60,32,1780.59,2,2,4,8
16383.0,74,102,668.36,2,4,2,8
16384.0,89,33,584.5,2,2,2,6
16385.0,59,59,555.89,2,3,2,7
16386.0,28,88,317.2,3,3,2,8
16387.0,322,4,94.36,1,1,1,3
16389.0,52,34,1382.07,2,2,3,7
16392.0,269,45,221.19,1,3,1,5
16393.0,1,330,3046.21,4,4,4,12
16394.0,56,83,1555.34,2,3,3,8
16395.0,60,210,1486.9,2,4,3,9
16398.0,153,82,1705.8,1,3,4,8
16399.0,18,73,408.57,3,3,2,8
16400.0,94,29,303.93,2,2,1,5
16401.0,0,186,4098.32,4,4,4,12
16402.0,264,60,299.6,1,3,1,5
16403.0,311,10,177.5,1,1,1,3
16404.0,69,23,443.05,2,2,2,6
16405.0,301,5,167.25,1,1,1,3
16406.0,18,63,163.07,3,3,1,7
16407.0,12,172,2126.93,4,4,4,12
16409.0,35,232,2028.88,3,4,4,11
16411.0,18,45,214.65,3,3,1,7
16412.0,53,35,151.83,2,2,1,5
16413.0,56,31,262.2,2,2,1,5
16414.0,21,7,126.25,3,1,1,5
16415.0,43,54,210.35,3,3,1,7
16416.0,26,71,1051.4,3,3,3,9
16418.0,44,102,675.27,3,4,3,10
16419.0,112,51,972.23,2,3,3,8
16422.0,16,369,34684.4,4,4,4,12
16423.0,24,18,346.12,3,2,2,7
16424.0,190,5,133.56,1,1,1,3
16425.0,301,21,302.7,1,2,1,4
16426.0,1,372,1908.25,4,4,4,12
16427.0,262,9,241.06,1,1,1,3
16429.0,105,2,284.55,2,1,1,4
16430.0,56,6,300.85,2,1,1,4
16431.0,212,83,642.81,1,3,2,6
16432.0,63,8,287.4,2,1,1,4
16433.0,27,17,184.26,3,1,1,5
16434.0,28,109,1522.25,3,4,3,10
16438.0,5,132,798.35,4,4,3,11
16440.0,7,282,3640.67,4,4,4,12
16441.0,66,24,381.2,2,2,2,6
16442.0,1,174,616.79,4,4,2,10
16444.0,45,84,654.67,3,3,2,8
16445.0,33,63,230.51,3,3,1,7
16446.0,0,3,168472.5,4,1,4,9
16447.0,135,36,259.01,2,2,1,5
16448.0,197,20,188.89000000000001,1,2,1,4
16449.0,197,40,707.69,1,2,3,6
16450.0,149,11,311.92,1,1,2,4
16451.0,87,14,266.97,2,1,1,4
16454.0,44,2,6.9,3,1,1,5
16455.0,63,99,1841.18,2,3,4,9
16456.0,98,111,2158.37,2,4,4,10
16457.0,217,9,208.36,1,1,1,3
16458.0,2,202,3482.7400000000002,4,4,4,12
16460.0,27,135,814.72,3,4,3,10
16461.0,177,33,151.42,1,2,1,4
16462.0,73,3,136.0,2,1,1,4
16463.0,20,82,1422.4,3,3,3,9
16464.0,19,236,1314.68,3,4,3,10
16466.0,33,148,1603.46,3,4,3,10
16468.0,73,2,74.9,2,1,1,4
16469.0,23,182,650.43,3,4,2,9
16470.0,51,170,762.39,2,4,3,9
16471.0,274,13,223.95000000000002,1,1,1,3
16473.0,164,18,316.11,1,2,2,5
16474.0,6,360,1871.5,4,4,4,12
16475.0,87,28,544.3,2,2,2,6
16477.0,63,146,2494.46,2,4,4,10
16478.0,24,17,331.0,3,1,2,6
16479.0,9,35,300.83,4,2,1,7
16480.0,75,53,769.29,2,3,3,8
16482.0,15,18,220.62,4,2,1,7
16483.0,191,19,139.35,1,2,1,4
16484.0,173,25,404.3,1,2,2,5
16485.0,76,42,363.65,2,3,2,7
16488.0,32,29,498.8,3,2,2,7
16491.0,46,39,731.5,3,2,3,8
16493.0,79,56,1351.63,2,3,3,8
16494.0,296,50,826.53,1,3,3,7
16495.0,2,97,684.41,4,3,3,10
16496.0,8,95,1599.52,4,3,3,10
16497.0,49,136,2965.69,3,4,4,11
16498.0,160,15,100.97,1,1,1,3
16499.0,359,19,365.45,1,2,2,5
16500.0,4,11,400.86,4,1,2,7
16503.0,106,84,1431.93,2,3,3,8
16504.0,24,86,484.38,3,3,2,8
16505.0,31,4,777.6,3,1,3,7
16506.0,19,3,90.30000000000001,3,1,1,5
16509.0,296,13,363.7,1,1,2,4
16510.0,371,13,248.1,1,1,1,3
16511.0,21,169,950.26,3,4,3,10
16513.0,4,35,874.59,4,2,3,9
16515.0,51,113,1627.13,2,4,3,9
16516.0,29,6,101.69999999999999,3,1,1,5
16517.0,276,17,162.7,1,1,1,3
16518.0,60,40,484.32,2,2,2,6
16519.0,24,13,215.07999999999998,3,1,1,5
16520.0,185,156,1046.57,1,4,3,8
16523.0,1,290,9418.470000000001,4,4,4,12
16525.0,1,183,13027.45,4,4,4,12
16526.0,171,15,290.36,1,1,1,3
16527.0,80,14,228.06,2,1,1,4
16528.0,3,17,244.41,4,1,1,6
16529.0,189,30,455.25,1,2,2,5
16531.0,21,77,1244.59,3,3,3,9
16532.0,17,4,6748.8,4,1,4,9
16533.0,18,177,1095.56,3,4,3,10
16535.0,4,31,593.75,4,2,2,8
16536.0,109,55,548.97,2,3,2,7
16539.0,2,45,1388.81,4,3,3,10
16542.0,53,5,119.62,2,1,1,4
16545.0,164,3,339.3,1,1,2,4
16546.0,290,25,787.15,1,2,3,6
16549.0,9,981,4154.64,4,4,4,12
16550.0,108,251,2298.97,2,4,4,10
16551.0,95,32,922.12,2,2,3,7
16552.0,242,17,379.73,1,1,2,4
16553.0,162,84,5719.82,1,3,4,8
16554.0,41,52,837.1,3,3,3,9
16555.0,34,17,285.89,3,1,1,5
16556.0,66,207,3313.79,2,4,4,10
16557.0,23,11,281.85,3,1,1,5
16558.0,0,460,8338.49,4,4,4,12
16560.0,26,57,841.41,3,3,3,9
16561.0,5,31,511.12,4,2,2,8
16563.0,53,19,1077.74,2,2,3,7
16565.0,363,3,173.7,1,1,1,3
16566.0,14,18,614.66,4,2,2,8
16567.0,193,35,865.6,1,2,3,6
16569.0,2,5,124.2,4,1,1,6
16570.0,14,126,3738.4,4,4,4,12
16571.0,26,87,1421.69,3,3,3,9
16572.0,126,57,1009.6,2,3,3,8
16573.0,84,42,663.61,2,3,2,7
16574.0,70,28,451.44,2,2,2,6
16581.0,182,9,105.84,1,1,1,3
16582.0,112,6,313.62,2,1,2,5
16583.0,373,14,233.45,1,1,1,3
16584.0,79,28,936.08,2,2,3,7
16586.0,248,8,463.95,1,1,2,4
16587.0,231,13,225.15,1,1,1,3
16589.0,70,33,459.24,2,2,2,6
16591.0,68,10,213.5,2,1,1,4
16592.0,3,216,4113.68,4,4,4,12
16593.0,50,27,330.03,3,2,2,7
16594.0,74,53,181.09,2,3,1,6
16595.0,60,85,360.16,2,3,2,7
16596.0,15,12,250.15,4,1,1,6
16597.0,3,7,90.04,4,1,1,6
16598.0,285,10,145.04999999999998,1,1,1,3
16600.0,3,62,813.52,4,3,3,10
16601.0,40,31,244.79999999999998,3,2,1,6
16602.0,35,29,528.08,3,2,2,7
16603.0,74,34,482.47,2,2,2,6
16607.0,17,172,3347.71,4,4,4,12
16609.0,14,276,5493.46,4,4,4,12
16610.0,218,6,75.66,1,1,1,3
16611.0,185,10,129.49,1,1,1,3
16612.0,32,66,1187.66,3,3,3,9
16613.0,69,30,618.59,2,2,2,6
16614.0,182,26,506.19,1,2,2,5
16616.0,14,33,500.42,4,2,2,8
16617.0,235,5,151.85,1,1,1,3
16618.0,30,96,2647.59,3,3,4,10
16619.0,263,14,226.21,1,1,1,3
16620.0,3,9,178.96,4,1,1,6
16621.0,51,29,813.48,2,2,3,7
16623.0,245,5,129.45,1,1,1,3
16624.0,80,48,810.5699999999999,2,3,3,8
16625.0,274,23,333.08,1,2,2,5
16626.0,0,179,4413.1,4,4,4,12
16627.0,78,20,322.8,2,2,2,6
16628.0,29,117,2188.05,3,4,4,11
16629.0,73,64,417.73,2,3,2,7
16633.0,16,152,2883.1,4,4,4,12
16634.0,222,9,217.9,1,1,1,3
16637.0,31,69,1154.47,3,3,3,9
16638.0,22,94,1680.72,3,3,4,10
16639.0,30,50,1257.51,3,3,3,9
16641.0,105,12,231.10000000000002,2,1,1,4
16642.0,4,34,688.33,4,2,3,9
16643.0,245,27,487.51,1,2,2,5
16644.0,177,62,833.78,1,3,3,7
16647.0,169,14,214.06,1,1,1,3
16648.0,42,19,290.65999999999997,3,2,1,6
16650.0,71,24,518.42,2,2,2,6
16652.0,58,118,6773.97,2,4,4,10
16653.0,15,69,1212.66,4,3,3,10
16654.0,140,29,601.27,2,2,2,6
16655.0,17,261,3794.52,4,4,4,12
16656.0,21,73,8625.8,3,3,4,10
16657.0,9,208,933.62,4,4,3,11
16658.0,367,8,123.24,1,1,1,3
16659.0,188,2,39.12,1,1,1,3
16660.0,15,16,1267.6499999999999,4,1,3,8
16665.0,361,9,135.39999999999998,1,1,1,3
16666.0,18,32,118.98,3,2,1,6
16667.0,67,53,570.13,2,3,2,7
16668.0,14,20,306.71999999999997,4,2,1,7
16669.0,23,160,1374.8700000000001,3,4,3,10
16670.0,16,252,4095.9,4,4,4,12
16671.0,27,6,1692.27,3,1,4,8
16672.0,1,114,8134.9400000000005,4,4,4,12
16674.0,54,98,319.61,2,3,2,7
16676.0,33,89,1592.1200000000001,3,3,3,9
16678.0,2,163,3109.99,4,4,4,12
16679.0,365,3,129.75,1,1,1,3
16680.0,42,10,183.7,3,1,1,5
16681.0,72,44,1770.34,2,3,4,9
16682.0,4,30,1028.0,4,2,3,9
16684.0,3,277,66653.56,4,4,4,12
16685.0,60,62,324.24,2,3,2,7
16686.0,46,585,3062.83,3,4,4,11
16688.0,0,62,1260.86,4,3,3,10
16689.0,75,13,422.59999999999997,2,1,2,5
16690.0,71,12,225.57999999999998,2,1,1,4
16692.0,255,3,1276.0,1,1,3,5
16693.0,68,60,482.01,2,3,2,7
16696.0,134,10,657.9000000000001,2,1,2,5
16697.0,240,21,112.75,1,2,1,4
16698.0,226,5,1998.0,1,1,4,6
16700.0,8,308,5076.55,4,4,4,12
16701.0,8,144,5398.3,4,4,4,12
16705.0,0,270,14034.99,4,4,4,12
16706.0,36,123,531.35,3,4,2,9
16708.0,45,27,656.63,3,2,2,7
16709.0,84,79,3029.87,2,3,4,9
16710.0,18,402,2483.04,3,4,4,11
16711.0,2,22,1651.03,4,2,3,9
16712.0,8,447,3645.43,4,4,4,12
16713.0,18,624,6923.13,3,4,4,11
16714.0,218,93,1161.53,1,3,3,7
16715.0,77,19,301.71999999999997,2,2,1,5
16716.0,266,2,901.2,1,1,3,5
16717.0,23,199,3858.38,3,4,4,11
16718.0,368,45,623.75,1,3,2,6
16719.0,14,201,1790.42,4,4,4,12
16720.0,25,27,155.24,3,2,1,6
16721.0,261,37,292.47,1,2,1,4
16722.0,16,225,4730.81,4,4,4,12
16723.0,90,43,589.15,2,3,2,7
16725.0,301,151,781.02,1,4,3,8
16726.0,25,185,1382.02,3,4,3,10
16727.0,363,46,272.82,1,3,1,5
16728.0,45,269,1054.67,3,4,3,10
16729.0,37,660,7239.92,3,4,4,11
16730.0,51,82,743.11,2,3,3,8
16732.0,31,28,603.75,3,2,2,7
16734.0,51,53,650.51,2,3,2,7
16735.0,78,125,2300.56,2,4,4,10
16737.0,52,1,417.59999999999997,2,1,2,5
16738.0,297,1,3.75,1,1,1,3
16739.0,176,13,323.0,1,1,2,4
16742.0,46,1,464.9,3,1,2,6
16743.0,28,191,2238.09,3,4,4,11
16744.0,10,242,1304.76,4,4,3,11
16745.0,86,357,7194.3,2,4,4,10
16746.0,4,449,6697.66,4,4,4,12
16747.0,37,42,836.06,3,3,3,9
16748.0,17,69,1515.9,4,3,3,10
16750.0,44,95,623.93,3,3,2,8
16751.0,30,25,1764.72,3,2,4,9
16752.0,372,9,207.5,1,1,1,3
16753.0,57,34,223.92000000000002,2,2,1,5
16754.0,371,2,2002.4,1,1,4,6
16755.0,113,170,1496.83,2,4,3,9
16756.0,214,13,239.4,1,1,1,3
16757.0,318,7,106.83000000000001,1,1,1,3
16758.0,64,22,369.34000000000003,2,2,2,6
16759.0,7,42,789.79,4,3,3,10
16761.0,96,13,316.62,2,1,2,5
16762.0,19,89,1501.38,3,3,3,9
16763.0,198,23,611.85,1,2,2,5
16764.0,3,706,2799.25,4,4,4,12
16765.0,293,1,34.0,1,1,1,3
16766.0,272,34,1145.6,1,2,3,6
16767.0,30,222,5580.6,3,4,4,11
16768.0,47,54,478.09000000000003,3,3,2,8
16769.0,259,40,380.39,1,2,2,5
16770.0,57,145,770.1,2,4,3,9
16771.0,32,255,2246.81,3,4,4,11
16773.0,56,26,171.59,2,2,1,5
16774.0,67,48,661.52,2,3,2,7
16775.0,9,158,1695.66,4,4,4,12
16776.0,59,76,388.28,2,3,2,7
16777.0,79,50,226.35,2,3,1,6
16778.0,73,16,245.94,2,1,1,4
16779.0,1,333,10629.720000000001,4,4,4,12
16780.0,99,60,425.19,2,3,2,7
16781.0,371,17,311.25,1,1,2,4
16782.0,9,190,2279.9,4,4,4,12
16784.0,19,3,107.6,3,1,1,5
16788.0,122,155,597.48,2,4,2,8
16789.0,7,5,80.8,4,1,1,6
16790.0,3,93,1545.6200000000001,4,3,3,10
16791.0,28,320,1721.78,3,4,4,11
16792.0,281,12,110.38000000000001,1,1,1,3
16793.0,56,16,243.84,2,1,1,4
16794.0,0,285,1222.71,4,4,3,11
16795.0,364,66,414.88,1,3,2,6
16796.0,88,18,305.62,2,2,1,5
16800.0,10,164,1201.49,4,4,3,11
16801.0,162,76,1619.73,1,3,3,7
16803.0,64,24,332.3,2,2,2,6
16804.0,22,60,536.99,3,3,2,8
16805.0,173,98,460.59,1,3,2,6
16806.0,102,103,801.49,2,4,3,9
16807.0,142,67,1121.59,1,3,3,7
16808.0,98,23,288.42,2,2,1,5
16809.0,22,149,914.69,3,4,3,10
16810.0,191,15,309.54,1,1,2,4
16811.0,4,28,547.07,4,2,2,8
16812.0,360,15,479.35,1,1,2,4
16813.0,7,449,1692.98,4,4,4,12
16814.0,13,324,6509.1,4,4,4,12
16816.0,102,28,417.06,2,2,2,6
16817.0,2,86,1604.75,4,3,3,10
16818.0,10,189,3349.57,4,4,4,12
16820.0,95,26,497.61,2,2,2,6
16823.0,226,38,358.38,1,2,2,5
16824.0,15,26,460.64,4,2,2,8
16825.0,38,28,775.1800000000001,3,2,3,8
16826.0,50,22,341.7,3,2,2,7
16828.0,92,8,128.5,2,1,1,4
16829.0,156,11,197.22,1,1,1,3
16830.0,38,23,325.91,3,2,2,7
16832.0,183,12,199.15,1,1,1,3
16833.0,0,47,1106.53,4,3,3,10
16834.0,227,24,413.46,1,2,2,5
16835.0,127,10,180.85,2,1,1,4
16836.0,39,11,251.87,3,1,1,5
16837.0,30,165,3170.98,3,4,4,11
16838.0,196,25,588.85,1,2,2,5
16839.0,8,266,16594.35,4,4,4,12
16841.0,36,116,1869.82,3,4,4,11
16842.0,100,63,1264.19,2,3,3,8
16843.0,42,378,10196.57,3,4,4,11
16846.0,49,11,214.32,3,1,1,5
16847.0,42,12,193.44,3,1,1,5
16848.0,52,14,281.42,2,1,1,4
16849.0,186,8,124.57,1,1,1,3
16850.0,333,19,332.41,1,2,2,5
16851.0,3,20,342.45,4,2,2,8
16852.0,9,9,144.91000000000003,4,1,1,6
16855.0,23,19,328.4,3,2,2,7
16856.0,14,2,35.400000000000006,4,1,1,6
16858.0,368,10,375.69000000000005,1,1,2,4
16859.0,144,52,747.81,1,3,3,7
16861.0,59,6,173.76,2,1,1,4
16863.0,30,26,502.8,3,2,2,7
16866.0,140,11,207.73999999999998,2,1,1,4
16869.0,22,128,825.42,3,4,3,10
16871.0,21,137,2812.34,3,4,4,11
16872.0,76,7,680.02,2,1,3,6
16873.0,4,279,7123.62,4,4,4,12
16875.0,66,112,2095.53,2,4,4,10
16877.0,11,159,853.72,4,4,3,11
16878.0,83,3,13.3,2,1,1,4
16880.0,30,178,1519.08,3,4,3,10
16881.0,66,1,432.0,2,1,2,5
16882.0,66,39,705.12,2,2,3,7
16883.0,186,38,276.73,1,2,1,4
16884.0,37,26,429.84000000000003,3,2,2,7
16885.0,14,101,471.51,4,4,2,10
16887.0,34,37,194.88,3,2,1,6
16889.0,194,135,1578.67,1,4,3,8
16891.0,1,203,809.7,4,4,3,11
16892.0,0,99,525.54,4,3,2,9
16893.0,366,45,145.93,1,3,1,5
16895.0,64,69,219.14,2,3,1,6
16897.0,298,37,289.78,1,2,1,4
16898.0,25,162,508.81,3,4,2,9
16899.0,7,125,1281.56,4,4,3,11
16900.0,16,79,887.11,4,3,3,10
16902.0,115,44,1706.88,2,3,4,9
16903.0,28,60,373.24,3,3,2,8
16904.0,3,710,3754.27,4,4,4,12
16905.0,4,208,3102.43,4,4,4,12
16906.0,81,93,579.77,2,3,2,7
16907.0,28,151,981.65,3,4,3,10
16909.0,71,18,379.14,2,2,2,6
16910.0,3,547,1510.06,4,4,3,11
16912.0,28,101,2575.38,3,4,4,11
16913.0,289,8,113.44,1,1,1,3
16914.0,35,38,208.46,3,2,1,6
16915.0,8,57,621.6800000000001,4,3,2,9
16916.0,23,143,576.26,3,4,2,9
16917.0,276,9,391.52,1,1,2,4
16918.0,49,128,1068.82,3,4,3,10
16919.0,155,327,2596.45,1,4,4,9
16921.0,60,60,169.79,2,3,1,6
16923.0,11,672,7247.61,4,4,4,12
16924.0,20,83,846.75,3,3,3,9
16926.0,370,14,230.25,1,1,1,3
16927.0,115,6,543.05,2,1,2,5
16928.0,79,209,2847.6,2,4,4,10
16929.0,3,77,1295.39,4,3,3,10
16930.0,25,54,380.55,3,3,2,8
16931.0,4,898,4604.22,4,4,4,12
16932.0,52,53,161.94,2,3,1,6
16933.0,0,44,563.23,4,3,2,9
16934.0,54,62,950.9300000000001,2,3,3,8
16936.0,25,57,262.68,3,3,1,7
16938.0,8,241,2736.38,4,4,4,12
16940.0,51,305,3049.88,2,4,4,10
16942.0,12,281,1920.59,4,4,4,12
16943.0,211,33,816.73,1,2,3,6
16945.0,21,249,4345.5,3,4,4,11
16947.0,235,21,406.48,1,2,2,5
16948.0,138,19,435.02,2,2,2,6
16949.0,3,60,1286.27,4,3,3,10
16950.0,56,42,1178.56,2,3,3,8
16951.0,134,86,1277.75,2,3,3,8
16952.0,108,16,167.61,2,1,1,4
16953.0,29,1,20.8,3,1,1,5
16954.0,0,54,2085.08,4,3,4,11
16955.0,184,25,518.67,1,2,2,5
16956.0,17,16,308.74,4,1,2,7
16957.0,238,16,416.64,1,1,2,4
16959.0,86,7,117.35000000000001,2,1,1,4
16960.0,38,101,507.05,3,4,2,9
16961.0,115,14,234.17,2,1,1,4
16963.0,186,7,110.55000000000001,1,1,1,3
16965.0,226,26,201.19,1,2,1,4
16966.0,7,28,2154.97,4,2,4,10
16967.0,188,21,319.02,1,2,2,5
16968.0,3,31,439.43,4,2,2,8
16969.0,38,42,650.41,3,3,2,8
16971.0,37,41,357.21,3,2,2,7
16976.0,266,2,251.51999999999998,1,1,1,3
16978.0,77,39,344.33,2,2,2,6
16979.0,3,89,1852.0,4,3,4,11
16980.0,254,87,1078.96,1,3,3,7
16982.0,60,22,384.06,2,2,2,6
16983.0,12,148,1931.25,4,4,4,12
16984.0,87,407,4481.35,2,4,4,10
16985.0,16,120,5464.12,4,4,4,12
16986.0,29,3,1873.2,3,1,4,8
16987.0,2,129,1625.05,4,4,3,11
16988.0,4,7,126.12,4,1,1,6
16989.0,6,12,1133.25,4,1,3,8
16990.0,218,1,179.0,1,1,1,3
16992.0,10,93,1614.31,4,3,3,10
16996.0,29,37,1456.96,3,2,3,8
16997.0,287,12,702.0,1,1,3,5
16998.0,149,4,295.0,1,1,1,3
16999.0,22,23,484.82,3,2,2,7
17001.0,0,169,3989.57,4,4,4,12
17002.0,85,49,1493.73,2,3,3,8
17004.0,45,44,1412.94,3,3,3,9
17006.0,4,44,781.78,4,3,3,10
17007.0,50,52,889.9300000000001,3,3,3,9
17010.0,17,11,195.36,4,1,1,6
17011.0,29,15,270.9,3,1,1,5
17014.0,7,74,586.33,4,3,2,9
17015.0,28,217,1842.56,3,4,4,11
17017.0,2,252,8694.26,4,4,4,12
17018.0,40,16,920.1,3,1,3,7
17019.0,10,234,1272.61,4,4,3,11
17022.0,30,7,71.0,3,1,1,5
17024.0,44,3,95.85,3,1,1,5
17025.0,60,9,357.77,2,1,2,5
17026.0,184,4,154.82999999999998,1,1,1,3
17027.0,78,153,890.29,2,4,3,9
17029.0,110,2,716.0,2,1,3,6
17030.0,63,11,146.87,2,1,1,4
17031.0,11,22,380.35,4,2,2,8
17033.0,85,28,1030.14,2,2,3,7
17034.0,15,30,745.52,4,2,3,9
17035.0,245,28,433.53000000000003,1,2,2,5
17037.0,87,75,1267.32,2,3,3,8
17038.0,29,22,112.4,3,2,1,6
17040.0,137,15,449.73,2,1,2,5
17041.0,26,70,1081.57,3,3,3,9
17042.0,2,98,1044.3799999999999,4,3,3,10
17043.0,31,102,1735.18,3,4,4,11
17044.0,24,6,948.48,3,1,3,7
17045.0,112,22,339.44,2,2,2,6
17046.0,156,22,642.02,1,2,2,5
17047.0,84,65,1100.9,2,3,3,8
17048.0,117,43,925.35,2,3,3,8
17049.0,2,318,5659.9800000000005,4,4,4,12
17050.0,95,316,3228.84,2,4,4,10
17051.0,193,43,247.14000000000001,1,3,1,5
17052.0,27,92,413.75,3,3,2,8
17053.0,130,13,498.48,2,1,2,5
17054.0,27,83,1356.33,3,3,3,9
17058.0,81,62,1179.89,2,3,3,8
17059.0,29,516,3095.04,3,4,4,11
17060.0,265,5,234.24,1,1,1,3
17061.0,73,99,5232.2300000000005,2,3,4,9
17062.0,313,70,538.37,1,3,2,6
17063.0,20,78,1461.14,3,3,3,9
17064.0,58,62,859.35,2,3,3,8
17068.0,11,296,4552.14,4,4,4,12
17069.0,27,143,2709.7000000000003,3,4,4,11
17070.0,113,64,312.14,2,3,2,7
17071.0,27,140,2429.03,3,4,4,11
17073.0,17,174,1446.09,4,4,3,11
17075.0,17,77,834.12,4,3,3,10
17076.0,35,25,841.0799999999999,3,2,3,8
17078.0,35,28,378.2,3,2,2,7
17079.0,77,2,118.80000000000001,2,1,1,4
17080.0,21,8,287.62,3,1,1,5
17081.0,24,64,290.16,3,3,1,7
17082.0,32,81,2003.85,3,3,4,10
17083.0,108,52,1405.78,2,3,3,8
17084.0,34,162,2949.75,3,4,4,11
17085.0,122,187,1566.65,2,4,3,9
17086.0,6,96,2050.08,4,3,4,11
17088.0,27,115,1991.01,3,4,4,11
17090.0,3,63,2043.95,4,3,4,11
17091.0,2,195,3827.76,4,4,4,12
17092.0,49,125,1777.78,3,4,4,11
17094.0,321,14,302.0,1,1,1,3
17095.0,22,74,1324.16,3,3,3,9
17096.0,14,48,1022.13,4,3,3,10
17097.0,1,211,954.42,4,4,3,11
17100.0,17,65,971.74,4,3,3,10
17101.0,9,42,1621.73,4,3,3,10
17102.0,261,1,25.5,1,1,1,3
17105.0,158,90,665.78,1,3,2,6
17107.0,32,418,10815.43,3,4,4,11
17109.0,28,117,885.04,3,4,3,10
17110.0,164,12,163.29999999999998,1,1,1,3
17111.0,46,30,248.61,3,2,1,6
17114.0,5,127,808.62,4,4,3,11
17115.0,7,39,837.5,4,2,3,9
17117.0,287,9,116.19999999999999,1,1,1,3
17118.0,317,10,157.02,1,1,1,3
17119.0,2,35,606.91,4,2,2,8
17120.0,232,18,307.46,1,2,2,5
17122.0,118,7,138.32,2,1,1,4
17123.0,161,9,345.29999999999995,1,1,2,4
17124.0,184,32,298.89,1,2,1,4
17125.0,49,40,259.35,3,2,1,6
17126.0,151,260,1004.75,1,4,3,8
17128.0,334,14,157.09,1,1,1,3
17131.0,4,134,2463.17,4,4,4,12
17133.0,15,27,4892.240000000001,4,2,4,10
17134.0,106,24,425.0,2,2,2,6
17135.0,15,52,1139.73,4,3,3,10
17138.0,275,24,380.5,1,2,2,5
17139.0,15,478,10668.47,4,4,4,12
17140.0,246,20,465.32,1,2,2,5
17142.0,238,15,579.0,1,1,2,4
17144.0,0,48,984.57,4,3,3,10
17146.0,105,35,749.78,2,2,3,7
17147.0,22,81,1714.59,3,3,4,10
17148.0,51,9,124.88,2,1,1,4
17152.0,194,14,1689.5,1,1,4,6
17153.0,23,14,213.78,3,1,1,5
17154.0,74,23,329.34,2,2,2,6
17155.0,17,20,251.70000000000002,4,2,1,7
17157.0,7,13,319.0,4,1,2,7
17158.0,31,67,1266.97,3,3,3,9
17159.0,21,101,1538.88,3,4,3,10
17160.0,30,229,3518.03,3,4,4,11
17162.0,28,104,1715.46,3,4,4,11
17163.0,21,5,293.1,3,1,1,5
17164.0,32,144,2467.35,3,4,4,11
17165.0,283,10,158.68,1,1,1,3
17166.0,38,12,206.34,3,1,1,5
17169.0,57,54,835.78,2,3,3,8
17171.0,288,16,224.91,1,1,1,3
17172.0,78,15,317.76,2,1,2,5
17173.0,4,86,3766.6,4,3,4,11
17174.0,217,4,59.9,1,1,1,3
17175.0,43,63,1443.69,3,3,3,9
17176.0,201,15,306.13,1,1,1,3
17179.0,177,80,711.79,1,3,3,7
17180.0,55,128,796.03,2,4,3,9
17181.0,56,23,239.92000000000002,2,2,1,5
17183.0,7,73,3347.31,4,3,4,11
17186.0,46,2,144.0,3,1,1,5
17187.0,226,10,203.95,1,1,1,3
17188.0,10,84,2474.23,4,3,4,11
17189.0,105,61,384.40000000000003,2,3,2,7
17190.0,58,19,444.74,2,2,2,6
17191.0,27,237,2095.13,3,4,4,11
17193.0,35,32,1699.3000000000002,3,2,4,9
17194.0,273,29,262.62,1,2,1,4
17197.0,29,29,1013.01,3,2,3,8
17198.0,23,96,692.22,3,3,3,9
17201.0,53,40,342.63,2,2,2,6
17203.0,35,152,3563.85,3,4,4,11
17204.0,174,57,1564.56,1,3,3,7
17205.0,53,13,384.08,2,1,2,5
17206.0,52,7,204.24,2,1,1,4
17211.0,26,211,2317.2200000000003,3,4,4,11
17212.0,252,4,226.85,1,1,1,3
17213.0,39,157,2781.23,3,4,4,11
17214.0,59,103,1069.1200000000001,2,4,3,9
17217.0,233,9,113.5,1,1,1,3
17218.0,3,274,1960.72,4,4,4,12
17219.0,31,25,114.23,3,2,1,6
17220.0,23,472,3198.25,3,4,4,11
17221.0,6,63,335.13,4,3,2,9
17222.0,64,28,354.15,2,2,2,6
17223.0,309,49,426.79,1,3,2,6
17226.0,308,21,393.49,1,2,2,5
17227.0,18,47,939.32,3,3,3,9
17228.0,15,208,1906.09,4,4,4,12
17229.0,95,47,318.76,2,3,2,7
17230.0,263,69,3638.41,1,3,4,8
17231.0,11,541,3174.32,4,4,4,12
17232.0,2,36,421.52,4,2,2,8
17233.0,34,25,190.88,3,2,1,6
17234.0,182,14,149.89000000000001,1,1,1,3
17235.0,24,29,550.06,3,2,2,7
17236.0,12,105,916.13,4,4,3,11
17237.0,10,19,314.69,4,2,2,8
17238.0,2,566,3744.65,4,4,4,12
17239.0,312,15,382.5,1,1,2,4
17242.0,107,40,1135.04,2,2,3,7
17243.0,0,400,8676.85,4,4,4,12
17244.0,52,31,954.9,2,2,3,7
17245.0,204,9,171.45,1,1,1,3
17247.0,14,55,282.19,4,3,1,8
17248.0,119,69,318.65,2,3,2,7
17250.0,3,57,384.52,4,3,2,9
17251.0,362,39,283.28000000000003,1,2,1,4
17252.0,116,87,353.86,2,3,2,7
17253.0,17,18,178.26,4,2,1,7
17254.0,4,112,272.44,4,4,1,9
17255.0,40,78,298.41,3,3,1,7
17256.0,106,16,240.0,2,1,1,4
17259.0,147,124,603.37,1,4,2,7
17262.0,51,12,1253.3600000000001,2,1,3,6
17263.0,207,23,63.440000000000005,1,2,1,4
17265.0,138,127,562.9,2,4,2,8
17266.0,1,80,310.64,4,3,2,9
17267.0,126,38,317.62,2,2,2,6
17268.0,107,6,763.64,2,1,3,6
17272.0,41,114,2148.63,3,4,4,11
17274.0,34,27,111.97999999999999,3,2,1,6
17277.0,227,69,1065.3500000000001,1,3,3,7
17278.0,240,15,246.04,1,1,1,3
17279.0,57,9,187.82999999999998,2,1,1,4
17282.0,129,94,1703.41,2,3,4,9
17284.0,59,292,1652.58,2,4,3,9
17286.0,21,45,153.92,3,3,1,7
17287.0,25,124,1064.11,3,4,3,10
17288.0,8,142,1419.73,4,4,3,11
17289.0,31,111,944.41,3,4,3,10
17290.0,3,102,525.24,4,4,2,10
17291.0,307,1,550.8000000000001,1,1,2,4
17293.0,7,135,1875.1100000000001,4,4,4,12
17295.0,28,69,556.95,3,3,2,8
17297.0,16,51,131.78,4,3,1,8
17298.0,100,30,498.42,2,2,2,6
17299.0,11,57,669.11,4,3,2,9
17301.0,20,66,197.63,3,3,1,7
17302.0,14,79,1135.63,4,3,3,10
17303.0,360,53,250.04,1,3,1,5
17306.0,10,66,8631.31,4,3,4,11
17309.0,94,12,82.75,2,1,1,4
17311.0,77,55,1384.85,2,3,3,8
17312.0,138,14,644.3,2,1,2,5
17313.0,30,24,2328.84,3,2,4,9
17314.0,24,131,2527.92,3,4,4,11
17315.0,1,473,6292.26,4,4,4,12
17317.0,45,9,2600.34,3,1,4,8
17320.0,99,73,1200.6200000000001,2,3,3,8
17321.0,7,107,700.86,4,4,3,11
17323.0,14,200,921.07,4,4,3,11
17324.0,17,50,990.23,4,3,3,10
17325.0,279,6,96.8,1,1,1,3
17329.0,13,33,523.11,4,2,2,8
17330.0,22,6,363.9,3,1,2,6
17331.0,123,1,175.2,2,1,1,4
17333.0,85,28,494.25,2,2,2,6
17334.0,301,11,307.02,1,1,1,3
17337.0,150,543,2027.8700000000001,1,4,4,9
17338.0,16,753,6643.93,4,4,4,12
17339.0,93,9,243.36,2,1,1,4
17340.0,29,407,12353.29,3,4,4,11
17341.0,156,183,781.36,1,4,3,8
17343.0,354,17,193.64,1,1,1,3
17344.0,45,32,160.57,3,2,1,6
17345.0,14,87,537.74,4,3,2,9
17346.0,3,500,2676.56,4,4,4,12
17347.0,85,1,228.96,2,1,1,4
17348.0,14,215,1159.52,4,4,3,11
17349.0,178,9,110.75,1,1,1,3
17350.0,7,71,1286.07,4,3,3,10
17351.0,35,27,587.15,3,2,2,7
17353.0,128,8,1740.0,2,1,4,7
17354.0,50,16,1393.06,3,1,3,7
17356.0,311,19,178.22,1,2,1,4
17357.0,23,45,388.14,3,3,2,8
17358.0,302,59,365.85,1,3,2,6
17359.0,10,15,127.86,4,1,1,6
17360.0,16,132,585.79,4,4,2,10
17361.0,48,29,488.2,3,2,2,7
17362.0,238,35,312.23,1,2,2,5
17364.0,0,411,4481.18,4,4,4,12
17365.0,12,468,4801.56,4,4,4,12
17367.0,237,34,168.4,1,2,1,4
17368.0,22,111,1912.67,3,4,4,11
17370.0,72,33,446.18,2,2,2,6
17371.0,16,87,423.89,4,3,2,9
17372.0,40,253,1342.68,3,4,3,10
17373.0,39,57,646.92,3,3,2,8
17374.0,218,28,495.77,1,2,2,5
17375.0,198,69,400.1,1,3,2,6
17376.0,70,24,203.2,2,2,1,5
17377.0,23,418,4100.92,3,4,4,11
17379.0,10,83,404.66,4,3,2,9
17381.0,8,109,20275.61,4,4,4,12
17382.0,64,2,65.4,2,1,1,4
17383.0,3,51,199.29,4,3,1,8
17384.0,18,15,336.4,3,1,2,6
17385.0,14,47,261.11,4,3,1,8
17386.0,7,28,2686.42,4,2,4,10
17387.0,19,78,784.11,3,3,3,9
17388.0,77,15,1259.56,2,1,3,6
17389.0,0,213,31833.68,4,4,4,12
17391.0,163,3,508.8,1,1,2,4
17392.0,306,62,457.91,1,3,2,6
17394.0,218,4,203.86999999999998,1,1,1,3
17396.0,38,27,7330.8,3,2,4,9
17397.0,21,92,696.41,3,3,3,9
17398.0,114,38,653.38,2,2,2,6
17400.0,125,213,2129.96,2,4,4,10
17402.0,4,59,2633.85,4,3,4,11
17403.0,35,33,281.62,3,2,1,6
17404.0,3,198,31906.82,4,4,4,12
17405.0,0,82,1031.41,4,3,3,10
17406.0,332,113,2200.42,1,4,4,9
17408.0,162,2,32.65,1,1,1,3
17409.0,184,13,771.85,1,1,3,5
17410.0,15,64,1214.72,4,3,3,10
17411.0,11,41,778.94,4,2,3,9
17412.0,2,66,1258.06,4,3,3,10
17414.0,43,6,778.0,3,1,3,7
17415.0,79,14,507.84,2,1,2,5
17416.0,29,269,6893.42,3,4,4,11
17418.0,41,30,463.46000000000004,3,2,2,7
17419.0,10,206,4226.57,4,4,4,12
17420.0,49,30,598.83,3,2,2,7
17422.0,15,117,1979.37,4,4,4,12
17423.0,45,26,698.41,3,2,3,8
17425.0,18,43,759.17,3,3,3,9
17426.0,7,271,5037.26,4,4,4,12
17427.0,71,2,100.8,2,1,1,4
17428.0,0,328,17256.85,4,4,4,12
17429.0,127,39,524.9200000000001,2,2,2,6
17430.0,32,14,265.76,3,1,1,5
17431.0,312,43,403.3,1,3,2,6
17432.0,17,48,365.76,4,3,2,9
17433.0,87,54,303.15999999999997,2,3,1,6
17434.0,1,134,2373.82,4,4,4,12
17436.0,1,9,216.29999999999998,4,1,1,6
17438.0,253,17,388.45000000000005,1,1,2,4
17440.0,156,5,186.42000000000002,1,1,1,3
17442.0,36,135,2248.56,3,4,4,11
17443.0,219,1,534.24,1,1,2,4
17444.0,147,135,2940.04,1,4,4,9
17446.0,176,9,120.9,1,1,1,3
17447.0,39,36,541.53,3,2,2,7
17449.0,1,277,2520.86,4,4,4,12
17450.0,7,337,194550.79,4,4,4,12
17451.0,0,100,1721.4,4,3,4,11
17453.0,17,19,486.71999999999997,4,2,2,8
17454.0,191,61,517.53,1,3,2,6
17455.0,203,8,131.7,1,1,1,3
17456.0,364,17,249.86,1,1,1,3
17457.0,126,19,1737.7,2,2,4,8
17458.0,14,54,316.5,4,3,2,9
17459.0,42,111,657.3,3,4,2,9
17460.0,93,29,622.4300000000001,2,2,2,6
17461.0,22,111,757.46,3,4,3,10
17462.0,59,27,675.69,2,2,3,7
17463.0,15,215,1896.41,4,4,4,12
17464.0,157,9,289.96000000000004,1,1,1,3
17466.0,9,41,763.28,4,2,3,9
17468.0,9,5,137.0,4,1,1,6
17469.0,15,88,1870.97,4,3,4,11
17470.0,44,78,1125.07,3,3,3,9
17472.0,190,181,710.29,1,4,3,8
17475.0,78,14,194.37,2,1,1,4
17480.0,77,29,511.82,2,2,2,6
17481.0,3,82,1255.59,4,3,3,10
17483.0,64,21,414.04,2,2,2,6
17486.0,260,24,396.87,1,2,2,5
17489.0,58,29,376.64,2,2,2,6
17490.0,0,76,2092.32,4,3,4,11
17491.0,0,109,3558.87,4,4,4,12
17492.0,247,12,374.57,1,1,2,4
17495.0,7,27,497.56,4,2,2,8
17496.0,358,10,271.05,1,1,1,3
17498.0,75,17,272.22,2,1,1,4
17499.0,289,40,622.88,1,2,2,5
17500.0,16,5,1138.0,4,1,3,8
17501.0,220,18,288.6,1,2,1,4
17502.0,8,28,689.1,4,2,3,9
17503.0,2,38,558.96,4,2,2,8
17504.0,205,127,2997.0299999999997,1,4,4,9
17505.0,161,52,1145.84,1,3,3,7
17506.0,75,14,302.2,2,1,1,4
17507.0,261,88,605.58,1,3,2,6
17508.0,280,22,387.31,1,2,2,5
17509.0,57,366,6115.14,2,4,4,10
17510.0,24,20,308.48,3,2,2,7
17511.0,2,963,91062.38,4,4,4,12
17512.0,28,105,2924.9900000000002,3,4,4,11
17513.0,71,6,513.2,2,1,2,5
17514.0,127,40,208.65,2,2,1,5
17515.0,30,87,639.02,3,3,2,8
17516.0,14,137,768.08,4,4,3,11
17517.0,308,11,153.94,1,1,1,3
17519.0,16,82,1844.02,4,3,4,11
17520.0,53,30,546.81,2,2,2,6
17521.0,29,45,723.2099999999999,3,3,3,9
17522.0,1,73,1070.71,4,3,3,10
17523.0,10,33,652.74,4,2,2,8
17524.0,360,6,145.0,1,1,1,3
17525.0,359,9,422.70000000000005,1,1,2,4
17526.0,4,19,1195.8999999999999,4,2,3,9
17527.0,53,47,939.37,2,3,3,8
17528.0,0,253,3628.5,4,4,4,12
17530.0,0,394,2385.0,4,4,4,12
17531.0,189,14,296.7,1,1,1,3
17534.0,53,9,223.36,2,1,1,4
17535.0,279,13,164.4,1,1,1,3
17536.0,176,3,76.5,1,1,1,3
17537.0,29,75,897.62,3,3,3,9
17538.0,25,9,98.42,3,1,1,5
17540.0,24,25,578.9,3,2,2,7
17542.0,269,25,170.75,1,2,1,4
17545.0,42,145,645.96,3,4,2,9
17548.0,233,5,103.3,1,1,1,3
17549.0,23,6,148.86,3,1,1,5
17550.0,196,42,267.16,1,3,1,5
17551.0,358,43,306.84,1,3,1,5
17552.0,59,49,930.41,2,3,3,8
17553.0,129,2,1487.6,2,1,3,6
17554.0,0,88,1952.45,4,3,4,11
17555.0,19,106,483.26,3,4,2,9
17556.0,205,6,157.9,1,1,1,3
17557.0,13,34,541.46,4,2,2,8
17560.0,94,27,854.95,2,2,3,7
17561.0,18,46,167.62,3,3,1,7
17562.0,13,63,1122.38,4,3,3,10
17564.0,23,49,454.01,3,3,2,8
17566.0,7,152,901.21,4,4,3,11
17567.0,6,165,4331.48,4,4,4,12
17569.0,331,29,344.14,1,2,2,5
17571.0,49,299,1498.51,3,4,3,10
17572.0,70,12,226.75000000000003,2,1,1,4
17573.0,28,25,380.6,3,2,2,7
17574.0,242,8,185.65,1,1,1,3
17576.0,7,411,3622.68,4,4,4,12
17578.0,217,5,143.45999999999998,1,1,1,3
17579.0,4,50,448.90000000000003,4,3,2,9
17580.0,252,45,215.72,1,3,1,5
17581.0,0,440,11045.04,4,4,4,12
17582.0,235,29,175.27,1,2,1,4
17584.0,6,35,1242.3,4,2,3,9
17585.0,108,214,1133.07,2,4,3,9
17588.0,99,23,1240.2,2,2,3,7
17589.0,59,253,2404.17,2,4,4,10
17590.0,1,201,1479.22,4,4,3,11
17591.0,72,166,2225.9700000000003,2,4,4,10
17593.0,3,213,3927.34,4,4,4,12
17594.0,84,50,993.18,2,3,3,8
17595.0,11,83,388.79,4,3,2,9
17596.0,22,270,2827.93,3,4,4,11
17597.0,213,55,2044.3700000000001,1,3,4,8
17600.0,17,13,161.67000000000002,4,1,1,6
17601.0,238,9,116.00999999999999,1,1,1,3
17602.0,1,560,5102.97,4,4,4,12
17603.0,77,11,394.72,2,1,2,5
17604.0,216,63,309.36,1,3,2,6
17608.0,32,59,193.42,3,3,1,7
17609.0,40,237,1112.22,3,4,3,10
17611.0,6,576,3984.22,4,4,4,12
17612.0,52,135,2048.45,2,4,4,10
17613.0,22,312,4559.150000000001,3,4,4,11
17614.0,56,100,390.07,2,3,2,7
17615.0,129,14,329.6,2,1,2,5
17616.0,173,3,571.1999999999999,1,1,2,4
17618.0,5,78,971.58,4,3,3,10
17619.0,311,77,218.52,1,3,1,5
17620.0,59,4,81.44,2,1,1,4
17621.0,20,26,1379.9,3,2,3,8
17623.0,32,33,527.0500000000001,3,2,2,7
17624.0,14,50,843.48,4,3,3,10
17625.0,17,315,2047.0,4,4,4,12
17628.0,80,5,75.75,2,1,1,4
17629.0,5,123,1814.12,4,4,4,12
17630.0,169,26,503.59999999999997,1,2,2,5
17631.0,1,39,528.33,4,2,2,8
17633.0,30,70,1324.84,3,3,3,9
17634.0,35,297,2361.9700000000003,3,4,4,11
17636.0,18,20,285.56,3,2,1,6
17637.0,30,35,547.0600000000001,3,2,2,7
17639.0,275,7,108.5,1,1,1,3
17640.0,86,5,621.66,2,1,2,5
17642.0,119,40,712.29,2,2,3,7
17643.0,372,8,101.55,1,1,1,3
17644.0,0,157,2895.64,4,4,4,12
17646.0,218,51,1008.39,1,3,3,7
17647.0,64,7,133.06,2,1,1,4
17648.0,60,91,1797.5,2,3,4,9
17649.0,137,52,868.49,2,3,3,8
17650.0,20,8,166.08,3,1,1,5
17651.0,11,232,3945.0,4,4,4,12
17652.0,24,259,4867.72,3,4,4,11
17653.0,36,44,1207.56,3,3,3,9
17654.0,276,22,117.55,1,2,1,4
17655.0,10,91,2638.94,4,3,4,11
17656.0,72,82,1674.69,2,3,4,9
17658.0,25,19,595.42,3,2,2,7
17659.0,16,158,2999.46,4,4,4,12
17660.0,140,45,196.0,2,3,1,6
17663.0,25,86,1802.91,3,3,4,10
17664.0,18,43,604.64,3,3,2,8
17666.0,3,18,728.16,4,2,3,9
17667.0,65,117,2055.51,2,4,4,10
17668.0,0,15,347.75,4,1,2,7
17669.0,42,68,3406.7200000000003,3,3,4,10
17670.0,227,11,205.7,1,1,1,3
17671.0,15,53,1572.71,4,3,3,10
17672.0,49,110,3178.17,3,4,4,11
17673.0,1,227,1629.12,4,4,3,11
17674.0,73,27,551.04,2,2,2,6
17675.0,0,705,20374.28,4,4,4,12
17676.0,3,78,1387.68,4,3,3,10
17677.0,1,304,16363.23,4,4,4,12
17678.0,263,16,298.11,1,1,1,3
17679.0,52,30,1992.1100000000001,2,2,4,8
17680.0,23,11,184.4,3,1,1,5
17682.0,9,118,2474.33,4,4,4,12
17684.0,43,15,239.41,3,1,1,5
17685.0,16,130,3191.53,4,4,4,12
17686.0,6,286,5739.46,4,4,4,12
17690.0,29,256,4757.95,3,4,4,11
17691.0,357,19,290.40000000000003,1,2,1,4
17692.0,126,46,740.9399999999999,2,3,3,8
17693.0,136,16,200.47,2,1,1,4
17694.0,141,15,283.12,2,1,1,4
17695.0,131,35,765.34,2,2,3,7
17696.0,37,115,2285.71,3,4,4,11
17697.0,235,19,338.95,1,2,2,5
17698.0,260,8,154.95,1,1,1,3
17700.0,16,142,2534.64,4,4,4,12
17701.0,252,24,417.95,1,2,2,5
17702.0,29,74,1824.37,3,3,4,10
17703.0,34,55,798.74,3,3,3,9
17704.0,168,31,885.19,1,2,3,6
17705.0,2,103,1823.52,4,4,4,12
17706.0,3,382,10504.49,4,4,4,12
17707.0,184,5,152.4,1,1,1,3
17708.0,187,35,267.08,1,2,1,4
17709.0,169,7,137.45,1,1,1,3
17711.0,10,23,385.1,4,2,2,8
17712.0,44,29,522.91,3,2,2,7
17714.0,320,10,153.0,1,1,1,3
17715.0,200,1,326.4,1,1,2,4
17716.0,22,245,5655.99,3,4,4,11
17718.0,231,6,139.35,1,1,1,3
17719.0,37,274,5396.04,3,4,4,11
17720.0,25,50,1195.94,3,3,3,9
17722.0,95,115,2424.04,2,4,4,10
17723.0,126,10,3276.4000000000005,2,1,4,7
17724.0,70,40,1033.0,2,2,3,7
17725.0,15,192,3439.08,4,4,4,12
17727.0,14,66,1060.25,4,3,3,10
17728.0,3,165,2876.01,4,4,4,12
17730.0,2,218,5298.4800000000005,4,4,4,12
17731.0,78,67,1240.11,2,3,3,8
17732.0,372,18,303.97,1,2,1,4
17733.0,38,35,692.19,3,2,3,8
17734.0,53,43,700.63,2,3,3,8
17735.0,1,690,13110.02,4,4,4,12
17736.0,8,25,377.44,4,2,2,8
17737.0,8,10,168.24,4,1,1,6
17738.0,18,97,1879.05,3,3,4,10
17739.0,11,47,2791.35,4,3,4,11
17742.0,112,15,355.11,2,1,2,5
17744.0,3,136,2322.4,4,4,4,12
17746.0,239,6,110.25,1,1,1,3
17747.0,112,1,71.4,2,1,1,4
17749.0,177,35,674.52,1,2,3,6
17750.0,4,193,1797.57,4,4,4,12
17752.0,358,1,80.64,1,1,1,3
17754.0,0,92,1772.26,4,3,4,11
17757.0,0,741,5605.29,4,4,4,12
17758.0,18,412,3456.7000000000003,3,4,4,11
17759.0,16,95,834.99,4,3,3,10
17760.0,21,25,287.59,3,2,1,6
17761.0,32,19,712.78,3,2,3,8
17763.0,262,1,15.0,1,1,1,3
17764.0,50,75,818.8199999999999,3,3,3,9
17765.0,158,57,371.88,1,3,2,6
17767.0,14,21,271.2,4,2,1,7
17768.0,7,105,2273.1800000000003,4,4,4,12
17769.0,12,310,3997.98,4,4,4,12
17770.0,198,38,1143.27,1,2,3,6
17771.0,56,54,245.81,2,3,1,6
17772.0,10,53,182.77,4,3,1,8
17774.0,96,156,1225.41,2,4,3,9
17775.0,254,3,56.4,1,1,1,3
17777.0,24,194,665.86,3,4,2,9
17779.0,20,82,658.57,3,3,2,8
17781.0,158,12,188.02,1,1,1,3
17783.0,71,67,283.47,2,3,1,6
17785.0,52,13,131.94,2,1,1,4
17786.0,84,72,278.74,2,3,1,6
17787.0,152,134,1865.19,1,4,4,9
17788.0,73,5,1117.9,2,1,3,6
17789.0,280,14,225.9,1,1,1,3
17790.0,26,190,1965.55,3,4,4,11
17791.0,29,10,106.1,3,1,1,5
17793.0,24,58,323.04,3,3,2,8
17795.0,179,46,350.39,1,3,2,6
17796.0,39,82,697.9,3,3,3,9
17797.0,21,111,780.43,3,4,3,10
17799.0,21,408,3055.93,3,4,4,11
17800.0,36,104,1199.01,3,4,3,10
17802.0,81,140,1285.04,2,4,3,9
17805.0,73,10,512.31,2,1,2,5
17806.0,10,43,546.04,4,3,2,9
17809.0,15,61,5411.91,4,3,4,11
17811.0,3,851,7837.7300000000005,4,4,4,12
17812.0,12,141,732.16,4,4,3,11
17813.0,13,371,1770.8799999999999,4,4,4,12
17816.0,36,17,36.56,3,1,1,5
17817.0,3,33,387.68,4,2,2,8
17819.0,71,48,3704.87,2,3,4,9
17824.0,50,13,298.4,3,1,1,5
17827.0,4,220,1995.46,4,4,4,12
17828.0,22,67,1820.09,3,3,4,10
17829.0,298,30,889.24,1,2,3,6
17830.0,1,23,398.7,4,2,2,8
17831.0,32,2,35.400000000000006,3,1,1,5
17832.0,49,61,155.37,3,3,1,7
17835.0,2,61,350.64,4,3,2,9
17836.0,46,24,110.21000000000001,3,2,1,6
17837.0,41,169,1593.38,3,4,3,10
17838.0,26,121,2779.3,3,4,4,11
17839.0,41,56,338.8,3,3,2,8
17841.0,1,7847,40991.57,4,4,4,12
17843.0,302,37,205.48,1,2,1,4
17844.0,106,5,51.559999999999995,2,1,1,4
17846.0,84,1,2033.1,2,1,4,7
17848.0,80,51,901.1999999999999,2,3,3,8
17849.0,217,26,605.8000000000001,1,2,2,5
17850.0,371,297,5391.21,1,4,4,9
17852.0,11,24,114.34,4,2,1,7
17854.0,184,15,311.26,1,1,2,4
17855.0,372,17,208.97,1,1,1,3
17856.0,1,15,1418.03,4,1,3,8
17857.0,3,54,26879.04,4,3,4,11
17858.0,5,199,5155.66,4,4,4,12
17859.0,304,25,148.21,1,2,1,4
17860.0,368,58,252.8,1,3,1,5
17861.0,2,222,2100.8,4,4,4,12
17862.0,323,11,330.9,1,1,2,4
17863.0,58,148,3160.0,2,4,4,10
17864.0,12,102,597.5,4,4,2,10
17865.0,30,370,10526.32,3,4,4,11
17866.0,142,9,329.65,1,1,2,4
17867.0,29,79,1197.1000000000001,3,3,3,9
17869.0,106,40,428.18,2,2,2,6
17870.0,1,279,1894.35,4,4,4,12
17871.0,204,10,155.9,1,1,1,3
17873.0,79,44,1859.16,2,3,4,9
17874.0,184,46,683.46,1,3,3,7
17877.0,169,12,237.61,1,1,1,3
17878.0,43,26,379.45,3,2,2,7
17879.0,173,6,178.51999999999998,1,1,1,3
17880.0,364,26,458.92,1,2,2,5
17881.0,303,8,133.35000000000002,1,1,1,3
17883.0,2,145,671.77,4,4,2,10
17884.0,3,117,717.45,4,4,3,11
17885.0,11,64,190.19,4,3,1,8
17886.0,31,109,899.61,3,4,3,10
17887.0,128,10,111.35,2,1,1,4
17888.0,20,67,726.05,3,3,3,9
17889.0,211,21,203.87,1,2,1,4
17890.0,322,94,602.09,1,3,2,6
17891.0,161,34,203.85999999999999,1,2,1,4
17892.0,55,28,244.1,2,2,1,5
17893.0,224,16,112.25,1,1,1,3
17894.0,71,193,1119.81,2,4,3,9
17895.0,43,16,98.0,3,1,1,5
17896.0,22,2,256.32,3,1,1,5
17897.0,172,114,566.6,1,4,2,7
17898.0,84,28,152.06,2,2,1,5
17899.0,158,32,155.8,1,2,1,4
17900.0,189,6,112.19999999999999,1,1,1,3
17901.0,28,19,110.38,3,2,1,6
17904.0,20,38,191.67,3,2,1,6
17905.0,70,34,800.24,2,2,3,7
17906.0,246,12,72.9,1,1,1,3
17908.0,373,58,243.28,1,3,1,5
17911.0,8,39,366.23,4,2,2,8
17912.0,309,38,311.01,1,2,2,5
17913.0,58,59,411.6,2,3,2,7
17914.0,3,80,336.43,4,3,2,9
17917.0,44,94,341.28,3,3,2,8
17919.0,87,23,1304.04,2,2,3,7
17920.0,3,696,4204.1,4,4,4,12
17921.0,63,145,826.52,2,4,3,9
17923.0,281,1,207.50000000000003,1,1,1,3
17924.0,11,31,2962.5,4,2,4,10
17925.0,372,1,244.08,1,1,1,3
17926.0,132,21,397.29,2,2,2,6
17928.0,44,23,212.54,3,2,1,6
17929.0,10,5,843.0,4,1,3,8
17930.0,35,39,1740.48,3,2,4,9
17931.0,133,65,408.36,2,3,2,7
17932.0,28,90,1331.57,3,3,3,9
17934.0,51,21,704.25,2,2,3,7
17935.0,137,29,145.79,2,2,1,5
17936.0,4,77,389.84,4,3,2,9
17937.0,8,43,4301.22,4,3,4,11
17939.0,159,12,99.14,1,1,1,3
17940.0,48,19,4106.4400000000005,3,2,4,9
17941.0,130,2,304.56,2,1,1,4
17942.0,7,2,77.50000000000001,4,1,1,6
17946.0,232,20,149.57999999999998,1,2,1,4
17947.0,36,9,176.68,3,1,1,5
17948.0,146,1,358.56000000000006,1,1,2,4
17949.0,0,70,58510.48,4,3,4,11
17950.0,71,71,482.2,2,3,2,7
17951.0,39,20,1008.5400000000001,3,2,3,8
17954.0,4,485,2332.72,4,4,4,12
17955.0,198,19,557.3,1,2,2,5
17956.0,248,1,12.75,1,1,1,3
17957.0,65,31,111.68,2,2,1,5
17958.0,116,7,508.4599999999999,2,1,2,5
17960.0,170,26,73.78,1,2,1,4
17961.0,20,249,1296.44,3,4,3,10
17962.0,141,35,102.83,2,2,1,5
17964.0,31,104,471.7,3,4,2,9
17965.0,37,329,2622.57,3,4,4,11
17966.0,37,68,1098.43,3,3,3,9
17967.0,371,48,123.07,1,3,1,5
17968.0,373,85,277.35,1,3,1,5
17969.0,165,14,228.2,1,1,1,3
17970.0,210,31,582.59,1,2,2,5
17972.0,241,31,136.04,1,2,1,4
17973.0,51,15,337.04,2,1,2,5
17974.0,24,179,740.79,3,4,3,10
17975.0,14,296,4488.81,4,4,4,12
17976.0,371,65,353.19,1,3,2,6
17977.0,28,21,288.14,3,2,1,6
17978.0,364,12,300.91999999999996,1,1,1,3
17979.0,35,146,757.71,3,4,3,10
17980.0,165,30,811.45,1,2,3,6
17984.0,144,48,152.68,1,3,1,5
17985.0,21,23,634.95,3,2,2,7
17986.0,55,1,20.8,2,1,1,4
17987.0,184,13,198.57,1,1,1,3
17988.0,11,38,201.12,4,2,1,7
17990.0,236,29,630.84,1,2,2,5
17991.0,224,5,93.35,1,1,1,3
17994.0,121,81,678.49,2,3,3,8
17995.0,281,2,76.1,1,1,1,3
17997.0,73,166,1970.6699999999998,2,4,4,10
17999.0,36,93,382.06,3,3,2,8
18001.0,11,58,417.23,4,3,2,9
18004.0,361,40,169.47,1,2,1,4
18005.0,3,60,249.72,4,3,1,8
18006.0,22,22,444.68,3,2,2,7
18008.0,69,30,2116.19,2,2,4,8
18009.0,234,32,257.34,1,2,1,4
18010.0,256,14,174.8,1,1,1,3
18011.0,372,28,102.78999999999999,1,2,1,4
18013.0,154,31,187.29,1,2,1,4
18014.0,27,32,166.42,3,2,1,6
18015.0,3,46,120.03,4,3,1,8
18016.0,31,123,1483.56,3,4,3,10
18017.0,80,3,523.0,2,1,2,5
18018.0,107,29,122.14,2,2,1,5
18019.0,51,5,38.45,2,1,1,4
18022.0,35,191,668.11,3,4,2,9
18024.0,152,21,389.78,1,2,2,5
18027.0,98,21,115.31,2,2,1,5
18030.0,3,9,230.64999999999998,4,1,1,6
18032.0,333,5,73.5,1,1,1,3
18033.0,64,34,97.97,2,2,1,5
18034.0,21,112,422.88,3,4,2,9
18035.0,35,53,730.4,3,3,3,9
18036.0,31,96,405.62,3,3,2,8
18037.0,153,19,70.02,1,2,1,4
18040.0,18,19,357.20000000000005,3,2,2,7
18041.0,11,472,4183.39,4,4,4,12
18042.0,53,7,165.04999999999998,2,1,1,4
18043.0,24,121,559.51,3,4,2,9
18044.0,3,127,2088.6,4,4,4,12
18045.0,44,47,189.4,3,3,1,7
18048.0,202,7,172.29000000000002,1,1,1,3
18050.0,358,5,74.4,1,1,1,3
18053.0,70,20,300.02,2,2,1,5
18055.0,6,360,6784.1900000000005,4,4,4,12
18056.0,287,19,363.65,1,2,2,5
18058.0,9,3,170.16,4,1,1,6
18059.0,22,19,306.46,3,2,1,6
18061.0,21,46,2119.41,3,3,4,10
18062.0,172,27,720.52,1,2,3,6
18064.0,132,7,814.0,2,1,3,6
18065.0,5,137,2392.83,4,4,4,12
18066.0,74,10,318.0,2,1,2,5
18067.0,39,37,396.33,3,2,2,7
18068.0,288,1,101.69999999999999,1,1,1,3
18069.0,25,470,2036.67,3,4,4,11
18071.0,257,25,453.0,1,2,2,5
18072.0,185,18,247.44,1,2,1,4
18073.0,113,73,3877.5200000000004,2,3,4,9
18074.0,373,13,489.6,1,1,2,4
18075.0,22,142,2611.75,3,4,4,11
18077.0,7,227,2633.0099999999998,4,4,4,12
18078.0,216,29,336.13,1,2,2,5
18079.0,44,127,3651.97,3,4,4,11
18080.0,18,2,1231.5,3,1,3,7
18081.0,35,17,343.45,3,1,2,6
18082.0,25,73,703.37,3,3,3,9
18084.0,15,1,90.47999999999999,4,1,1,6
18085.0,329,29,689.95,1,2,3,6
18086.0,273,7,101.34,1,1,1,3
18087.0,97,2,4055.7199999999993,2,1,4,7
18088.0,60,39,167.67000000000002,2,2,1,5
18092.0,1,89,9068.26,4,3,4,11
18093.0,92,36,2106.52,2,2,4,8
18094.0,81,70,3017.3,2,3,4,9
18095.0,312,21,580.0500000000001,1,2,2,5
18096.0,11,213,911.15,4,4,3,11
18097.0,7,108,2697.8,4,4,4,12
18099.0,126,19,168.31,2,2,1,5
18101.0,10,41,223.65,4,2,1,7
18102.0,0,431,259657.3,4,4,4,12
18104.0,36,38,754.64,3,2,3,8
18105.0,37,18,113.48000000000002,3,2,1,6
18106.0,329,39,430.7,1,2,2,5
18108.0,253,17,271.0,1,1,1,3
18109.0,1,444,8052.97,4,4,4,12
18110.0,19,46,236.3,3,3,1,7
18112.0,11,26,352.69,4,2,2,8
18113.0,368,1,76.32000000000001,1,1,1,3
18114.0,289,28,220.1,1,2,1,4
18116.0,67,378,1418.03,2,4,3,9
18117.0,25,74,320.72,3,3,2,8
18118.0,10,1279,5653.82,4,4,4,12
18119.0,367,30,181.12,1,2,1,4
18120.0,213,17,111.15,1,1,1,3
18121.0,148,32,673.1,1,2,2,5
18122.0,7,364,1826.21,4,4,4,12
18123.0,23,36,589.4399999999999,3,2,2,7
18125.0,29,196,1142.99,3,4,3,10
18126.0,60,56,206.82999999999998,2,3,1,6
18127.0,18,47,348.73,3,3,2,8
18129.0,242,14,112.55000000000001,1,1,1,3
18130.0,14,70,1059.39,4,3,3,10
18133.0,211,1,931.4999999999999,1,1,3,5
18135.0,28,20,681.9100000000001,3,2,3,8
18136.0,62,38,784.33,2,2,3,7
18138.0,294,8,152.65,1,1,1,3
18139.0,17,159,8438.34,4,4,4,12
18142.0,156,15,1019.52,1,1,3,5
18143.0,116,61,1000.16,2,3,3,8
18144.0,7,43,2888.75,4,3,4,11
18145.0,12,221,2861.55,4,4,4,12
18146.0,140,10,160.35000000000002,2,1,1,4
18147.0,45,7,179.33999999999997,3,1,1,5
18149.0,50,16,612.0799999999999,3,1,2,6
18150.0,31,37,566.58,3,2,2,7
18151.0,134,38,653.35,2,2,2,6
18154.0,2,21,399.19,4,2,2,8
18155.0,74,25,371.62,2,2,2,6
18156.0,12,140,734.94,4,4,3,11
18158.0,8,34,453.4,4,2,2,8
18159.0,300,23,530.15,1,2,2,5
18160.0,56,39,638.0600000000001,2,2,2,6
18161.0,14,80,1618.69,4,3,3,10
18164.0,36,24,399.65000000000003,3,2,2,7
18165.0,176,10,302.46000000000004,1,1,1,3
18167.0,22,37,1384.8600000000001,3,2,3,8
18168.0,175,131,1169.94,1,4,3,8
18169.0,60,9,202.65,2,1,1,4
18170.0,32,38,980.31,3,2,3,8
18171.0,58,54,1231.31,2,3,3,8
18172.0,14,189,7561.68,4,4,4,12
18173.0,86,31,2106.84,2,2,4,8
18174.0,6,1,104.0,4,1,1,6
18176.0,357,30,476.35,1,2,2,5
18177.0,30,74,1341.42,3,3,3,9
18178.0,128,97,1590.81,2,3,3,8
18179.0,8,90,1793.17,4,3,4,11
18180.0,4,119,1843.75,4,4,4,12
18181.0,23,44,382.8,3,3,2,8
18183.0,226,37,632.07,1,2,2,5
18184.0,14,1,49.8,4,1,1,6
18185.0,248,17,304.25,1,1,1,3
18188.0,14,71,2001.04,4,3,4,11
18189.0,77,68,1090.24,2,3,3,8
18190.0,191,15,284.46000000000004,1,1,1,3
18191.0,261,7,207.79999999999998,1,1,1,3
18192.0,71,45,957.97,2,3,3,8
18193.0,164,16,243.76,1,1,1,3
18194.0,81,7,973.8399999999999,2,1,3,6
18196.0,94,141,689.13,2,4,3,9
18198.0,3,159,5425.56,4,4,4,12
18200.0,105,32,163.8,2,2,1,5
18202.0,199,68,1396.99,1,3,3,7
18203.0,156,19,160.42000000000002,1,2,1,4
18204.0,70,200,1993.7,2,4,4,10
18205.0,35,32,517.36,3,2,2,7
18209.0,28,8,139.10000000000002,3,1,1,5
18210.0,1,134,2621.38,4,4,4,12
18211.0,25,42,600.07,3,3,2,8
18212.0,325,43,248.42,1,3,1,5
18213.0,236,15,232.48000000000002,1,1,1,3
18215.0,88,13,299.34000000000003,2,1,1,4
18216.0,30,26,481.75,3,2,2,7
18217.0,28,31,621.75,3,2,2,7
18218.0,210,21,662.08,1,2,2,5
18219.0,2,114,2069.77,4,4,4,12
18220.0,226,2,305.28000000000003,1,1,1,3
18221.0,21,64,1041.61,3,3,3,9
18222.0,92,19,443.0,2,2,2,6
18223.0,4,272,6484.54,4,4,4,12
18224.0,263,10,158.95000000000002,1,1,1,3
18225.0,2,271,5509.12,4,4,4,12
18226.0,43,242,5228.05,3,4,4,11
18227.0,217,5,93.75,1,1,1,3
18228.0,56,30,779.9,2,2,3,7
18229.0,11,164,7276.900000000001,4,4,4,12
18230.0,8,86,2810.2000000000003,4,3,4,11
18231.0,191,124,2083.27,1,4,4,9
18232.0,81,37,592.97,2,2,2,6
18233.0,325,1,440.0,1,1,2,4
18235.0,71,104,1796.48,2,4,4,10
18236.0,29,49,882.24,3,3,3,9
18237.0,2,61,987.1,4,3,3,10
18239.0,218,88,1561.6100000000001,1,3,3,7
18240.0,45,6,422.58,3,1,2,6
18241.0,9,104,2073.09,4,4,4,12
18242.0,71,78,2232.4900000000002,2,3,4,9
18245.0,6,175,2567.06,4,4,4,12
18246.0,23,4,596.1,3,1,2,6
18248.0,122,47,804.02,2,3,3,8
18249.0,16,8,95.34,4,1,1,6
18250.0,309,21,349.27,1,2,2,5
18251.0,86,16,4314.72,2,1,4,7
18252.0,50,98,526.67,3,3,2,8
18255.0,88,6,103.3,2,1,1,4
18257.0,38,118,2337.63,3,4,4,11
18259.0,24,42,2338.6000000000004,3,3,4,10
18260.0,172,134,2643.2000000000003,1,4,4,9
18261.0,42,21,324.24,3,2,2,7
18262.0,139,13,149.48,2,1,1,4
18263.0,25,61,1213.1599999999999,3,3,3,9
18265.0,71,46,801.51,2,3,3,8
18268.0,133,1,25.5,2,1,1,4
18269.0,365,7,168.6,1,1,1,3
18270.0,37,11,283.15,3,1,1,5
18272.0,2,166,3078.58,4,4,4,12
18273.0,1,3,204.0,4,1,1,6
18274.0,29,11,175.92,3,1,1,5
18276.0,43,14,335.86,3,1,2,6
18277.0,57,8,110.38,2,1,1,4
18278.0,73,9,173.9,2,1,1,4
18280.0,277,10,180.60000000000002,1,1,1,3
18281.0,180,7,80.82,1,1,1,3
18282.0,7,12,178.05,4,1,1,6
18283.0,3,756,2094.88,4,4,4,12
18287.0,42,70,1837.28,3,3,4,10
